&quot;: &quot;
&quot;إذا: &quot;if
&quot;اسمحوا&quot;: &quot;let&quot;
&quot;الطيور: &quot;the birds
&quot;النسر: the eagle
&quot;انظر: &quot;look
&quot;تقديم: &quot;submit
&quot;طريقي: &quot;my way
&quot;كل: &quot;all
&quot;كلمة: &quot;a word
&quot;لا: &quot;no
&quot;مهما: &quot;whatever
&quot;مواي: &quot;moai
&quot;نعم: yes
&quot;هل: &quot;do you
&quot;هيا: &quot;come on
&quot;وهذا: &quot;and this is
': ''
'أنت: 'you are
'اسمحوا': 'let'
'الجمارك': 'the customs'
1225: 1225
17: 17
2000: 2000
30: 30
40: 40
80: 80
99: 99
afsin: afsin
afsin؟: afsin
agabey: agabey
akcakoca: akcakoca
alp: alp
aykiz: aykiz
en: en
gundogdu: gundogdu
hayme: hayme
i: i
kara: kara
kayi: kayi
shahzadas: shahzadas
sungur: sungur
tekin: tekin
toygar: toygar
turgut: turgut
webvtt: webvtt
yigit: yigit
،: ،
،،: ،،
؟: 
؟،: ؟،
آباءك: your fathers
آتي: came
آثامهم: their sins
آجلا: later
آجلاً: soon
آخذ: taking
آخذهم: take them
آخر: last
آخر؟: else
آذان: ears
آسف: sorry
آغا: aغاa
آغا؟: aغاa
آفاق: horizons
آلاف: thousands
آلام: the mother
آلامهم: their pain
آمالنا: our hopes
آمل: hopefull
آمن: security
آمنة: safe
آمنًا: safe
آمين: trustworthy
آن: that
آوى: accommodate
آيكيز: ikeez
أ: a
أؤدي: i do
أؤمن: i believe
أب: father
أب؟: father
أبا: oppa
أبانا: our father
أبت: abt
أبحث: search
أبدا: start
أبداً: start
أبدو: i look
أبدية: eternity
أبدًا: start
أبرص: cyprus
أبصقها: spit it out
أبطال: champions
أبعد: far
أبقاني: keep me
أبقى: he kept
أبكي: i cry
أبلغ: inform
أبلغكم: inform you
أبلغنا: we informed
أبلغه: inform him
أبناء: children
أبناءنا؟: our children
أبناؤنا: our children
أبنائه: his sons
أبنائي: my children
أبواب: door
أبوك: your father
أبوك؟: your father
أبى: my father
أبي: my father
أبي؟: my father
أبيض: white
أبينا: our father
أتألم: i hurt
أتابعهم: i follow them
أتت: came
أتحدث: i speak
أتحقق: i check
أتخلى: i give up
أتذكر: i remember
أتراجع: i hold back
أتراك: turks
أتردد: i hesitate
أترك: leave
أتركك: i leave you
أتروجرول: atrogrol
أتساءل: i wonder
أتصرف: i act
أتصل: call
أتعامل: i deal
أتعب: tired
أتقدم: i extend
أتمكن: i could
أتمنى: i wish
أتناول: i touch
أتنفس: i breathe
أتوا: they came
أتوا؟: they came
أتوسل: i beg
أتوقع: i expect
أتيت: you come
أتيحت: made available
أثار: effects
أثارت: raised
أثبتت: proven
أثرتهم: i raised them
أثق: i trust
أثناء: during
أجبت: i answered
أجبرني: forced me
أجبني: answer me
أجد: i find
أجدادك: your grandparents
أجدادنا: our ancestors
أجدادها: her grandparents
أجده: i find it
أجدي: ajdi
أجريت: conducted
أجزاء: parts
أجسادنا: our bodies
أجعل: make
أجل: for
أجلك: for you
أجلنا: yes
أجله: yes
أجلهم: yes they
أجلي: yeah
أجمل: the most beautiful
أجهزك: equip you
أجوز: i may
أحاول: i'm trying
أحب: i love
أحبائنا: our loved ones
أحبائها: loved ones
أحبائهم: loved ones
أحبائي: my loved ones
أحببت: i loved it
أحتاج: i need
أحجم: he stopped
أحد: one
أحدا: no one
أحداً: no one
أحدهم: someone
أحرار: are free
أحررك: free you
أحررها: edit it
أحرق: burnt
أحرقت: burned
أحزمها: pack it
أحزن: grieve
أحسنت: well done
أحصل: get
أحضان: embrace
أحضر: brought
أحضرت: i brought
أحضرتها: i brought it
أحضره: bring it
أحضرها: bring it
أحضروا: they brought
أحضروه: they brought him
أحضروها: bring it
أحضري: bring up
أحفاد: grandsons
أحفادنا: our grandchildren
أحفادهم: their grandchildren
أحكام: provisions
أحكم: judge
أحلات: referrals
أحلامك: your dreams
أحلامي: my dreams
أحلى: sweetest
أحياء: biology
أخ: brother
أخ؟: brother
أخبار: news
أخباراً: news
أخبارك؟: how are you
أخبر: tell
أخبرت: i told
أخبرتك: i told you
أخبرتني: you told me
أخبرته: i told him
أخبرتها: i told her
أخبرك: i tell you
أخبرنا: tell us
أخبرنى: tell me
أخبرنى؟: tell me
أخبرني: tell me
أخبره: tell him
أخبرهم: tell them
أخت: sister
أخت؟: sister
أختبئ: i hide
أختك: your sister
أختنا: our sister
أخته: his sister
أختى؟: my sister
أختي: my sister
أخجل: ashamed
أخذ: taking
أخذت: i took
أخذتك: i took you
أخذتني: she took me
أخذته: i took it
أخذك: he took you
أخذنا: we took
أخذني: took me
أخذهم: take them
أخذوا: they took
أخرج: get out
أخرجني: get me out
أخرجه: take it out
أخرى: other
أخرى؟: other
أخشى: i'm afraid
أخطأت: mistaken
أخفتته؟: you hid it
أخفتك؟: i scared you
أخفيها: hide it
أخلاقك؟: your manners
أخلاقها: manners
أخلصك: save you
أخواتي: my sisters
أخواننا: our brothers
أخوة: brothers
أخوك: your brother
أخوك؟: your brother
أخي: brother
أخي؟: brother
أخير: last
أخير؟: last
أخيرة: one last
أخيرة؟: one last
أخيرًا: finally
أخيك: your brother
أخينا: our brother
أخيه: brother
أداة: a tool
أدبكم: your adab
أدخل: enter
أدر: turn
أدرت: i turned
أدرك: realized
أدركت: i realized
أدع: i pray
أدعو: i invite
أدفع: push
أدنى: minimum
أدهم: adham
أذرع: arms
أذكر: i remember
أذكرك: i remember you
أذن: ear
أذنه: his ear
أذني: my ears
أذنيك: your ears
أذهب: go
أذهل: startled
أر: r
أراد: want
أرادت: she wanted
أرادنا: he wanted us
أرادوا: they wanted
أراضي: lands
أراضينا: our territory
أراضيهم؟: their land
أراك: see you
أراكم: see you
أراه: i see it
أراها: see her
أراهم: show them
أرتغرول: artgrol
أرتوغرول: artogrol
أرجو: please
أرجوك: i beg you
أرد: answer
أردت: i wanted
أردت؟: i wanted
أردنا: we wanted
أرسل: send
أرسلت: i sent
أرسلتك؟: i sent you
أرسلتني: you sent me
أرسلتهم: i sent them
أرسلنا: we sent
أرسلناه: we sent it
أرسلني: he sent me
أرسله: send it
أرسلهم: send them
أرسلوا: they sent
أرض: a land
أرضنا: our land
أرطغرل: أرطغرل
أرطغرل؟: ertugrul
أرغب: i want
أرغوس: argos
أرفض: i refuse
أرق: insomnia
أركض: i run
أرميه: i throw it
أرني: show me
أره: see him
أرها: show her
أرواح: spirits
أرواحنا: our souls
أرى: i see
أرى؟: i see
أريد: i want
أريدك: i want you
أريده: want it
أريدهم: i want them
أرَك: see you
أزعجك: bother you
أسأل: ask
أسألك: i ask you
أسألني: ask me
أسألها: ask her
أسئلتك: your questions
أساطير: legends
أساطيرنا: our myths
أساعدك: i help you
أسبوع: a week
أستاد: stadium
أستادي: stadium
أستاذ: professor
أستجوبك: i question you
أستحق: deserve
أستريح: i rest
أستطع: i could
أستطيع: i can
أستمع: listen
أستهلك: i consume
أستيقظ: get up
أسد: lion
أسد؟: lion
أسر: capturing
أسرار: secrets
أسرع: faster
أسرنا: our families
أسطورة: legend
أسفل: down
أسفل؟: down
أسقط: drop
أسكب: pour
أسلافها: their ancestors
أسلافي: my ancestors
أسلحة: arms
أسلحتنا: our weapons
أسلم: safer
أسلمك: i deliver you
أسماء: the names
أسماءك: your names
أسمائهم: their names
أسمح: allow
أسمع: listen
أسميه: i call
أسنانه: his teeth
أسهب: amplified
أسهل: easier
أسهل؟: easier
أسوأ: worst
أسوار: fences
أسود: black
أسير: prisoner
أشارك: i share
أشجع: i encourage
أشعر: i feel
أشعل: lit
أشعلنا: we ignited
أشعلها: ignite it
أشفق: pity
أشكر: i thank
أشكرك: thank you
أشهد: i witness
أشهر: months
أشياء: things
أصبت: i was injured
أصبح: had become
أصبحت: i became
أصبحنا: we became
أصبحوا: they became
أصحاء: healthy
أصدق: believe
أصدقاء: friends
أصدقائي: my friends
أصدقهم: believe them
أصر: he insisted
أصرت: she insisted
أصعب: harder
أصلي: a native
أصم: deaf
أصواتنا؟: our voices
أصولك: your assets
أصيب: injured
أصيبوا: they were injured
أضاءت: lit up
أضر: harm
أضربه: hit him
أضع: i put
أطرح: i put
أطعمك: feed you
أطفأت: switched off
أطفال: children
أطفالنا: our children
أطفالي: my children
أطلب: i request
أطلبه: ask for it
أطول: longer
أطيع: i obey
أطيعك: i obey you
أظن: i suspect
أظهر: show up
أظهرت: i showed
أعادت: brought back
أعتبره: consider it
أعتقد: think
أعد: prepared
أعداء: enemies
أعدت: prepared
أعدك: i promise you
أعذار: excuses
أعرضك: introduce you
أعرف: i know
أعرفه: i know him
أعرفهم: i know them
أعضاء: members
أعط: give
أعطاك: he gave you
أعطاني: he gave me
أعطاه: gave him
أعطاهم: he gave them
أعطني: give me
أعطها: give her
أعطهم: give them
أعطونا: they gave us
أعطى: gave
أعطي: gave
أعطيت: was given
أعطيتك: i gave you
أعطيتني: you gave me
أعطيته: i gave it
أعطيتها: i gave her
أعطيها: give her
أعظم: greatest
أعلامنا: our flags
أعلم: i know
أعلن: advertise
أعماله: its works
أعمدوني: baptize me
أعمق: deeper
أعمل: make
أعمى: blind
أعني: i mean
أعنيه: i mean
أعود: i come back
أعيدنا: get us back
أعيش: i live
أعيننا: our eyes
أغا: agha
أغابي؟: agape
أغابيس؟: agapes
أغادر: i leave
أغاس: agas
أغاس؟: agas
أغبى: dumbest
أغسل: wash
أغضب: angered
أغلق: close
أغلقنا: we closed
أغلى: more expensive
أغنامنا: our sheep
أغنياء: rich
أغنية: song
أفرغك: empty you
أفسر: i explain
أفسين: afsin
أفصل: unplug
أفضل: best
أفعال: acts
أفعالك: your actions
أفعل: i do
أفعل؟: i do
أفعله: i'm doing
أفكر: think
أفكر؟: think
أفندي: effendi
أفندي؟: efendi
أفهم: i understand
أفهمك: i understand you
أقارب: relatives
أقتلك: i kill you
أقتلكم: i kill you
أقدام: feet
أقدم: the oldest
أقرب: closer
أقسم: i swear
أقسمت: i swore
أقصد: i mean
أقصر: shorter
أقل: less
أقلق: worry
أقنع: convince
أقنعنا: he convinced us
أقول: i say
أقوله: i'm saying
أقوم: do i
أقوى: more powerful
أقوياء: strong
أكاذيب: lies
أكاكوكا: akakuka
أكاكوكا؟: akakuka
أكبر: larger
أكبر؟: larger
أكتولجالي: actulgale
أكتولجالي؟: actulgali
أكثر: more
أكذب: i lie
أكل: ate
أكلت: ate
أكلك: eat you
أكن: i wouldn't
أكون: i be
أكياس: bags
ألا: except
ألب: alp
ألب؟: alp
ألسنتك: your tongues
ألصق: paste
ألعاب: toys
ألعب: play
ألف: a thousand
ألقابه: his titles
ألقت: she threw
ألقى: cast down
ألقيت: thrown
ألم: pain
ألمك: your pain
ألمى: my pain
ألن: allen
ألوم: i blame
أليس: isn't it
أليف: elif
أم: mother
أم؟: mother
أماكنهم: their places
أمام: before
أمامك: in front of you
أمامنا: in front of us
أمامه: in front of him
أمامهم: in front of them
أمامي: in front of me
أمانا: safer
أمانع: mind
أمانوس: amanos
أمانًا: secure
أماً: as for
أمتعته: his luggage
أمر: command
أمرت: ordered
أمرتنا: ordered us
أمره: his order
أمروا: they ordered
أمس: yesterday
أمس؟: yesterday
أمسك: catch
أمسكنا: we caught
أمك: your mother
أمل: amal
أمن: security
أمنا: our mother
أمنيتي: my wish
أمهير: amhair
أموالنا: our money
أموت: i die
أمي: illiterate
أمي؟: illiterate
أمير: prince
أمير؟: prince
أميل: dont
أمينة: honest
أمًا: as for
أن: that
أن؟: that
أنا: i am
أنا؟: i am
أنام: i sleep
أنت: you are
أنت؟: you are
أنتظر: wait
أنتقل: he moved
أنتم: you
أنتما: you
أنجح: succeed
أنحاء: over
أنشأنا: we created
أنضم: join
أنطاكية: antioch
أنظر: look
أنفاسك: your breath
أنفاسنا: our breath
أنفاسه: his breath
أنفسكم: yourselves
أنفسهم: themselves
أنفي: my nose
أنقذ: save
أنقذت: she saved
أنقذتنا: she saved us
أنقذك: save you
أنقذنا: he saved us
أنقذني: save me
أنك: that you are
أنكرت: i denied
أننا: that we
أنني: that i am
أنه: it's a
أنها: it
أنهم: that they
أنهى: finish
أنهي: finish
أنهِ: it's a
أنواع: species
أنوفنا: our noses
أنوفنا؟: our noses
أهلا: welcome
أهمية: importance
أهنئ: congratulate
أهنتني: you insulted me
أو: or
أوامر: orders
أوامري: my orders
أوجوز: oguz
أود: i would
أوراق: leaves
أورشليم: jerusalem
أوروبا: europe
أوستا: aosta
أوستا؟: aosta
أوصلك: pick you up
أوعدك: i promisse
أوغلو: ihsanoglu
أوغوز: oguz
أوقات: times
أوقفه: stop it
أوقفهم: stop them
أول: first
أولئك: those
أولا: firstly
أولادك: your children
أولادي: my children
أولاً: firstly
أولية: preliminary
أوه: oh
أي: which
أيام: days
أيامه: his days
أية: verse
أيد: supported
أيدي: hands
أيدينا: our hands
أيديهم: their hands
أيضا: also
أيضًا: also
أيضًا؟: also
أيقظنا: we woke up
أيكيز: aikies
أين: where
أين؟: where
أينما: wherever
أيها: ye
أيهم: ayham
إبادة: extermination
إبراهيم: ibrahim
إبرة: needle
إبلاغ: report
إبلاغنا: inform us
إتبعها: follow her
إتروجرول: etrogrol
إتروجرول؟: etrogrol
إتروغرول؟: etrogrol
إثارة: excitement
إجابة: answer
إجازة: a vacation
إحضار: bring
إحضاره: bring it
إخبار: news
إخبارك: tell you
إخراج: directed by
إخفاء: hide
إخوانك: your brothers
إخواننا: our brothers
إخواني: my brothers
إخوة: brothers
إدخال: enter
إذا: if
إذاً: if
إذن: ear
إذن؟: ear
إذنك: your permission
إذنكم: your permission
إذننا: our permission
إذهب: go
إرادة: will
إرادتك: your will
إرادتك؟: your will
إراقة: spilling
إرتغرول: ertugrul
إرتغرول؟: ertugrul
إرتوجرول: ertugrul
إرتوغرول: إرتوغرول
إرتوغرول؟: ertugrul
إرسال: send
إرسالك: your submission
إرضائك: please
إزاء: about
إسادورا: isadora
إسما: noun
إشارة: signal
إشراكك: engage you
إشعال: ignite
إضاعة: wasting
إضافة: addition
إضافي: additional
إضعاف: double
إطلاق: release
إطلاقه: launch it
إعادة: re
إعداد: prepare
إعدامه،: his execution,
إعطاء: give
إعطائهم: give them
إغواء: seduction
إفتاليا: ephtalia
إقامة: accommodation
إقليم: province
إقناع: persuade
إقناعه: convince him
إكسيسمان: xesman
إكمال: completion
إلا: except
إلانورا: elanora
إلقاء: throw
إله: god
إلهام: important
إلهي: divine
إلى: to
إلى؟: to me
إلي: to me
إلياس: despair
إليك: to you
إليكم: to you
إليه: mechanism
إليه؟: mechanism
إليها: to her
إليها؟: to her
إما: as for
إمارة: emirate
إمكاناتنا: our potential
إن: that
إنسان: man
إنفاق: expenditure
إنقاذ: rescue
إنقاذنا: save us
إنك: you
إننا: we are
إنني: i am
إنه: it's a
إنها: it
إنهاء: ending
إنهم: that they
إهمال: neglecting
إياه: him
إياها: it
إيجاد: finding
إيذاء: harming
إيرلدوم: earldom
إيزادورا؟: isadora
إيقافه: stop it
إيلانورا: elanora
إيمي: amy
إيمي؟: amy
إِذَا: if
إِنَّهُ: it's a
ا؟: a
االرب: the lord
اباركك: i bless you
ابتعد: stay away
ابتلاعها: swallow it
ابتليت: plagued
ابدا: start
ابعد: far
ابق: stay
ابقني: keep me
ابقى: stay
ابن: son
ابنا؟: a son
ابنة: daughter
ابنتك: your daughter
ابنته: his daughter
ابنتي: my daughter
ابنتي؟: my daughter
ابنك: your son
ابننا: our son
ابنه: daughter
ابنه؟: daughter
ابنها: her son
ابني&quot;: my son&quot;
ابني: my son
ابني؟: my son
ابي: my father
اتبعني: follow me
اتجاه: direction
اتحدث: i speak
اتحدوا: unite
اتخاذ: take
اتخذت: taken
اتخذناه: we have taken
اتخذها: take it
اترك: leave
اتركني: leave me
اتركه: leave it
اتركوا: leave
اتصال: connection
اتصالك: your call
اتصل: call
اتصلت: i called
اتعلم: you know what
اتفهم: i understand
اتمنى: i wish
اتهام: accusation
اثنان: two
اثنين: two
اجب: duty
اجتاحت: swept
اجتماعات: meetings
اجتمع: met
اجعل: make
اجلس: sit
اجمل: the most beautiful
احتاجت: she needed
احترس: watch out
احتفظ: keep
احتفظت: i kept
احتوائه: contain it
احتوائها: contain
احد: one
احرص: be careful
احسب: calculate
احصل: get
احضرت: i brought
احضرتهم: i brought them
احضرهم: bring them
احلام: dreams
احلامك: your dreams
احمل: i carry
اخبرني: tell me
اختار: choose
اختبأت: i hid
اختبأوا: they hid
اختبار: test
اختبارات: tests
اختبارها: tested
اختراق: breakthrough
اخترت: i chose
اختطاف: abduction
اختطف: he was kidnapped
اختطفت: she was kidnapped
اختطفوها: they kidnapped her
اختي: my sister
اختيار: selection
اخرج: get out
اخماد: suppression
اخماده: put it out
اخو: brother
اخوان: two brothers
اخوانك: your brothers
اخواننا: our brothers
اخوة: brothers
اخونا: our brother
اخي: brother
اخي؟: brother
اخيك؟: your brother
اخيه: brother
ادعمني: support me
ادعى: claimed
اذا: if
اذن: so
اذهب: go
ارتدته؟: i wore it
ارتدى: wear
ارتفاع: height
ارتكبت: committed
ارتكبنا: we committed
ارتكبه: committed
ارجع: come back
ارجوك: i beg you
ارسل: send
ارطغرل: ertugrul
ارطغرل؟: ertugrul
ارطغرول: ertugrul
ارى: i see
ارى؟: i see
اريد: i want
اسأل: ask
اساعدك: i help you
اساعدك،: i help you,
استأجروه: they rented him
استادي: stadium
استجواب: questioning
استجوابك: questioning you
استجوبته: i questioned him
استحق: deserve
استخدام: use
استخدامها: use it
استخدم: use
استدار: turned round
استدعاء: call up
استدعت: summoned
استرخاء: relaxation
استريح: rest
استريحي: rest
استضافهم: hosted
استضفهم: host them
استطعت: i could
استطعنا: we could
استطيع: i can
استعاد: recovered
استعادة: recovery
استعد: get ready
استعداد: ready
استعدوا: brace up
استغرق: it took
استغلال: exploit
استفز: provoke
استفزاز: provocation
استفزاك: provocation
استقر: settle down
استقرت: stabilized
استلهام: inspiration
استمر: continue
استمرارية: continuation
استمرت: continued
استمع: listen
استنفادنا: our exhaustion
استنفذ: exhausted
استيقظ: get up
اسم: noun
اسما: a name
اسمح: allow
اسمحوا: let
اسمع: listen
اسمعني: listen to me
اسمعوا: listen
اسمك: your name
اسمك؟: your name
اسمه: its name
اسمه؟: its name
اسمي: my name
اشارة: signal
اشتاقه: i miss him
اشتروا: they bought
اشترى: buy
اشتريته: i bought it
اشتريتها: bought it
اشتقت: i miss
اشرب: drink
اشكر: i thank
اصبح: has become
اصدقائي،: my friends,
اصطحابها: pick her up
اصطحبه: take him
اصطحبهم: take them
اصطياده: catching
اصمت: shut up
اصنع: make
اضطراب: disturbance
اضغط: click
اطفالهم: their children
اطلاع: looking at
اطلاق: release
اظهار: show
اعتاد: he used
اعتادني: he used me
اعتذاري: apologetic
اعتراض؟: objection
اعتزازك: your pride
اعتقادي: my belief
اعتقال: arrest
اعتقدت: i thought
اعتن: take care
اعتنقه: embrace it
اعتني: took care of
اعثر: find
اعدامه: his execution
اعرف: i know
اعطني: give me
اعطيك: i give you
اعفيني: pardon me
اعلم: i know
اعلم،: i know,
اعماقي: deep down
اعني: i mean
اغابي: agape
اغسل: wash
افتح: open
افتراء: defamation
افترق: parted
افتقد: miss
افتيليا؟: avtilia
افعل: i do
افعلها: do it
افكر: think
اقبل: accept
اقتراح: suggestion
اقترب: come closer
اقتربت: i approached
اقتل: kill
اقتلتم: you killed
اقتلني: kill me
اقتله: kill him
اقتلهم: kill them
اقرب: closer
اقسم: i swear
اقنعه: persuade him
اقول: tell
اكتشاف: discovery
اكتشفنا: we discovered
اكتمل: completed
اكتولجالي: actulgally
اكتولغالي: actualgale
اكتولغالي؟: actualgal
اكثر: more
اكون: i be
الآب: the father
الآب،: the father,
الآب؟: the father
الآبار: wells
الآثار: archaeology
الآخر: the other
الآخرين: others
الآسيوية: asian
الآلاف: thousands
الآلام: pains
الآن: right now
الآن؟: right now
الآونة: times
الأب: the father
الأب،: the father,
الأب؟: the father
الأبد: forever
الأبراج: horoscopes
الأبرياء: innocent
الأبواب: the doors
الأبيض: the white
الأتراك: turks
الأثناء: meantime
الأجنبية: foreign
الأحبة: sweethearts
الأحداث: events
الأحزان: sorrows
الأحكام: provisions
الأحلام: dreams
الأحمر: the red
الأحياء: biology
الأحيان: sometimes
الأخ: the brother
الأخبار: news
الأخت: sister
الأخرى: other
الأخرى؟: other
الأخوة: the brothers
الأخير: the last one
الأخيرة: last
الأخيرة؟: last
الأخيرين: the last two
الأدب: literature
الأدغال: the jungle
الأدوية: pharmaceutical
الأراضي: lands
الأربعاء: wednesday
الأربعة: the four
الأرثوذكس: orthodox
الأرجح: most likely
الأرض: earth
الأرض؟: earth
الأرواح: spirits
الأرواح؟: spirits
الأسئلة: questions
الأستاذ: the professor
الأسد: the lion
الأسرار: secrets
الأسرى: the prisoners
الأسرى؟: the prisoners
الأسلحة: weapons
الأسنان: the teeth
الأسوأ: the worst
الأسود: the black
الأسير: the captive
الأشخاص: persons
الأشياء: the things
الأصدقاء: friends
الأصعب: the hardest
الأصوات: sounds
الأضرار: damages
الأطفال: children
الأعداء: enemies
الأعشاب: herbs
الأعمال: business
الأغنام: sheep
الأفراس: mares
الأفضل: best
الأفق: horizon
الأقصى: the maximum
الأقل: the least
الأقواس: brackets
الأكاذيب: lies
الأكاذيب؟: lies
الأكبر: the biggest
الأكثر: most
الأكثر؟: the most
الأكل: eater
الألب: alps
الألسنة: tongues
الألغام؟: mine
الألم: the pain
الألوان: colors
الأم: the mother
الأم؟: the mother
الأماكن: the places
الأمامي: anterior
الأمر: command
الأمر؟: the matter
الأمراء: princes
الأمس: yesterday
الأمس؟: yesterday
الأمل: hope
الأملس: soapstone
الأمهات: mothers
الأمور: things
الأمومة: motherhood
الأمير: the prince
الأمير؟: the prince
الأناضول: anatolia
الأناضول،: anatolia,
الأنثى: the female
الأندلس: andalus
الأنسب: the most appropriate
الأنفاس: breaths
الأنماط: patterns
الأنهار: rivers
الأنين: whining
الأهمية: importance
الأوان: time
الأوتار: tendons
الأوروبيين: europeans
الأوساخ: the dirt
الأوغاد: scoundrels
الأوقات: times
الأول: the first
الأولى: first
الأولية: primary
الأوهام: illusions
الأيام: the days
الأيمن: right
الأيوبي: ayoubi
الإثارة: excitement
الإجابة: the answer
الإخوة: the brothers
الإذن: permission
الإزعاج: hassle
الإسلامي: islamic
الإسلامي؟: islamic
الإطلاق: all
الإعدام: execution
الإفطار: the breakfast
الإقليم: territory
الإله: god
الإلهي: divine
الإلهية: divine
الإمارة: the principality
الإمكان: possible
الإنتاج: production
الإنسان: the human
الإنصاف: fairness
الإنصاف؟: fairness
الإنقاذ: rescue
الإيمان: faith
الابرياء: innocent
الابن: son
الاتجاه: direction
الاتصال: connection
الاتصالات: telecommunications
الاتفاق: the agreement
الاتهام: accusation
الاتهامات: accusations
الاثار: archaeology
الاثنان: the two
الاحتجاج: protest
الاحترام: respect
الاحتمالات: possibilities
الاحتياطات: precautions
الاختباء: hiding
الاختبار: the test
الاختيار: the choice
الاخوة: the brothers
الادخار: saving
الادعاء: prosecution
الارتفاع: height
الارض: earth
الازدهار: prosperity
الاستجواب: interrogation
الاستخبارات: intelligence
الاسترخاء: relax
الاستسلام: to give in
الاستشاريين: consultants
الاستعداد: getting ready
الاستعدادات: preparations
الاستفادة: benefit
الاستفزاز: provocation
الاستفسار: inquiry
الاستقرار: stability
الاستماع: listen
الاستمتاع: enjoy
الاستمرار: continuation
الاستيقاظ: waking up
الاسطبل: the stable
الاسطبلات: stables
الاسود؟: the black
الاشاعة: the rumor
الاشقر: blond
الاشقر؟: blond
الاضطراب: turbulence
الاضطرابات: troubles
الاطمئنان: reassurance
الاعتبار: mind
الاعتراف: confession
الاعتقاد: belief
الاعتناء: look after
الافتراء: slander
الافتراءات: slander
الاقتراب: get closer
الاكتئاب: depression
الالتزام: commitment
الالتقاء: convergence
الالهي: the divine
الام: the mother
الام؟: the mother
الامتحان: the exam
الامتناع: refrain
الان: right now
الان؟: right now
الانتباه: attention
الانتصارات: wins
الانتظار: wait
الانتعاش: recovery
الانتفاض: uprising
الانتفاضة: uprising
الانتقام: revenge
الانتهاء: finished
الانحدار: regression
الانضمام: join
الانفصال: separation
الاهم: more important
الب؟: alp
البئر: well
البائس: wretched
البائسة: wretched
الباب: the door
الباب؟: the door
البابا: the pope
البابوية: the papacy
البارجو: pargo
البارجو؟: pargo
الباردة: cold
البازلاء: peas
الباسل: the brave
الباسلة: valiant
الباقي: the rest
الباكر: early
البالغين: adults
البالية: worn out
الباي: the bey
البايز: the bayes
البايز؟: bayes
البت: deciding
البحث: search
البحر: the sea
البدء: get started
البداية: the beginning
البدو: bedouins
البذور: seeds
البر: righteousness
البرد: the cold
البرسلان: perslan
البرق: lightning
البرق؟: lightning
البركة: pond
البريء: innocent
البريئة: innocent
البرية: wild
البسونغر: bessinger
البسونغور: the besongor
البشرية: humanity
البصرة: basra
البضائع: the goods
البعض: other
البقاء: stay
البقري: bovine
البلاد: country
البلد: country
البلدان: the countries
البلديات: municipalities
البلوط: oak
البندقية: venice
البهلوانات: tumblers
البومة: the owl
البيات: bayat
البيادق: pawns
البيض: eggs
البيع: sale
البيك: pick
التأخير: delay
التأرجح: swing
التأكد: making sure
التاج: the crown
التاجر: the merchant
التباهي: to brag
التجارب: experiments
التحالف: alliance
التحدث: speak
التحرر: emancipation
التحضير: preparation
التحفظات: reservations
التحقق: check
التحقيق: investigation
التخلص: get rid
التخلي: give up
التخييم: camping
التراب: dirt
الترتيب: ranking
الترحيب: welcome
الترحيل: deportation
الترك: turk
التركمان: turkmen
التركمانية: turkmen
التركمانية؟: turkmen
التركي: turkish
التركيز: the focus
التزام: commitment
التسول: begging
التشنجات: convulsions
التضحية: the sacrifice
التطورات: developments
التعازي: condolences
التعامل: deal
التعاون: cooperat
التعذيب: torture
التعرف: identify
التعلم: learning
التغلب: overcoming
التفاح: apple
التفكير: thinking
التقاط: capture
التقط: pick up
التقينا: we met
التكلفة: the cost
التلال: the hills
التلة: the hill
التمثيل: the acting
التمرد: rebellion
التمرين: the exercise
التنانير: skirts
التنظيف: cleaning
التنفس: breathing
التنوير؟: enlightenment
التنين: the dragon
التهديد: the threat
التهم: counts
التواجد: presence
التوالي: respectively
التوفيق: conciliation
التي: which
الثانية: the second
الثروات: wealth
الثعابين: snakes
الثعبان: serpent
الثقة: confidence
الثقل: heaviness
الثقيلة: heavy
الثكنات: barracks
الثلاثة: all three
الثلوج: snow
الثمن: the price
الثمين: precious
الثمينة: precious
الجائع: hungry
الجائعة: hungry
الجانب: the side
الجاني: the culprit
الجبال: mountains
الجبان: coward
الجبل: the mountain
الجبناء: cowards
الجحيم: hell
الجد: grandpa
الجدول: table
الجديد: the new
الجديد؟: the new
الجديدة: new
الجرح: the wound
الجري: running
الجريح: the wounded
الجريح؟: the wounded
الجريحة: the wounded
الجريمة: the crime
الجزء: section
الجزر: carrots
الجسر: the bridge
الجسم: the body
الجفاف: drought
الجلاد: executioner
الجلد: skin
الجلود؟: leather
الجلوس: sit down
الجمارك: the customs
الجماعي: collective
الجمال: beauty
الجمال؟: beauty
الجمرة: carbuncle
الجمل: camel
الجملة: sentence
الجمهور: the audience
الجميز: sycamore
الجميع: everybody
الجميل: beautiful
الجميلة: the beautiful
الجميلة،: the beautiful,
الجميلة؟: the beautiful
الجناة: perpetrators
الجناة؟: the culprits
الجنازات: funerals
الجنة: the paradise
الجندي: the soldier
الجنود: soldiers
الجواسيس: spies
الجوانب: aspects
الجوز: walnut
الجوع: hunger
الجيد: good
الجيدة: good looking
الجيش: army
الحاجة: the need
الحاكم: the ruler
الحاكمة؟: the ruling
الحال: adverb
الحالة: case
الحب: the love
الحبال: chords
الحبس: confinement
الحبس؟: confinement
الحجارة: stones
الحجر: stone
الحجر؟: stone
الحدس: intuition
الحدود: the border
الحديث: the talk
الحديث؟: the talk
الحديد: iron
الحديدية: ferrous
الحذر: caution
الحرارة: the heat
الحراس: the guards
الحراسة: guarding
الحرس: the guard
الحرية: freedom
الحزب: party
الحزن: sorrow
الحسنات: good deeds
الحشمة: decency
الحصان: the horse
الحصول: get
الحصى: gravel
الحظ: luck
الحظ،: luck,
الحفاظ: keep
الحق: right
الحقائق: the facts
الحقل: field
الحقيقة: truth
الحقيقي: real
الحقيقية: the real
الحقيقيون: the real
الحقيقيين: real people
الحكم: judgment
الحكماء: the elders
الحكمة: wisdom
الحكيم: the wise
الحل: the solution
الحلفاء: allies
الحلقة: the ring
الحلم: the dream
الحلوة: sweet
الحلوة؟: sweet
الحليب: the milk
الحمام: the bathroom
الحماية: protection
الحمد: praise
الحمقى: fools
الحمل: pregnancy
الحملة: the campaign
الحواجب: eyebrows
الحي: neighborhood
الحياة: life
الحيل: tricks
الحين: now
الحين؟: now
الحيوانات: the animals
الخائن: the traitor
الخائن؟: the traitor
الخادم: server
الخادمات: maids
الخادمة: the maid
الخارج: the outside
الخارج؟: the outside
الخاص: the private
الخاصة: own
الخبث: slag
الخبث؟: slag
الخبر: the news
الخبر؟: ahh
الخبز: the bread
الختم: the seal
الختم؟: the seal
الخدعة: the trick
الخدمة: the service
الخراب: the damage
الخراف: sheep
الخرج: output
الخروج: exit
الخريطة: the map
الخزانة: cabinet
الخزينة: treasury
الخسارة: loss
الخشب: the wood
الخصبة: fertile
الخضوع: submission
الخط: line
الخطأ: the error
الخطأ؟: the error
الخطة: the plan
الخطر: the danger
الخطط: plans
الخطوة: step
الخلاف: disagreement
الخلف: back
الخلفية: the background
الخلق: creation
الخلود: eternity
الخنزير: pig
الخوف: the fear
الخونة: traitors
الخيام: tents
الخيام؟: tents
الخيانة: treason
الخير: the good
الخيل: horses
الخيمة: the tent
الخيمة؟: the tent
الخيول: horses
الداخل: inside
الداخل؟: inside
الداخلي: procedure
الداخلي؟: procedure
الداكنة: dark
الدب: the bear
الدخول: access
الدراج: pheasant
الدرب: trail
الدرج؟: the stairs
الدرجة: class
الدرس: the lesson
الدرع: shield
الدعاء: pray for
الدعم: the support
الدعوة: the invitation
الدفق: stream
الدم: the blood
الدماء: blood
الدمعة: teardrop
الدموع: tears
الدنيا: dunya
الدنيوي: worldly
الدودة: the worm
الدور: the role
الدول: countries
الدولة: country
الديدان: worms
الدين: religion
الدين؟: religion
الذئاب: wolves
الذئب&quot;: the wolf&quot;
الذئب: the wolf
الذبول: wilting
الذكاء: intelligence
الذكرى: anniversary
الذهاب: going
الذهب: gold
الذهبي: golden
الذوق: taste
الذى؟: which
الذي: which
الذين: whose
الرأس: head
الرئيسي: the main
الرائدة: leading
الراحة: comforts
الراحلة: the late
الراعي: shepherd
الراهن: the present
الراية: raya
الربط: connectivity
الربيع: the spring
الرجاء: please
الرجال: men
الرجال؟: men
الرجل: the man
الرجل؟: the man
الرحل: nomads
الرحلات: trips
الرحلة: the journey
الرحم: uterus
الرحمة: mercy
الرحمن: merciful
الرحيل: leave
الرحيم: merciful
الرخاء: prosperity
الرد: reply
الردود: responses
الرسائل: messages
الرسالة: the message
الرسل: the apostles
الرضوخ: caving
الرعاة: sponsors
الرعاية: care
الرعشات: shivers
الرغم: though
الرغوة: foam
الرفاهية: luxury
الرقبة: the neck
الرقيق: the kind
الركض: jogging
الركوع: kneeling
الرماد: ash
الرمح: the spear
الرمل: the sand
الرموز: icons
الروث: manure
الروح: spirit
الرياح: wind
الريح: the wind
الزاوية: the corner
الزرقاء: apartment for sale located in zarqa
الزفاف: wedding
الزنادقة: heretics
الزنديق: heretic
الزنزانة: the cell
الزنزانة؟: the cell
الزهرة: venus
الزواج: marriage
الزوايا: corners
الزيارة: the visit
الزيتية: oily
السؤال: the question
السائد: prevailing
الساحر: the magician
الساحرة: the witch
الساخن: hot
الساذجة: naive
السار: good
السارة: pleasant
الساق: the leg
السبب: reason
السبب؟: reason
السبل: avenues
الستائر: curtains
السجاد: carpets
السجل: the record
السجل؟: the record
السجن: the prison
السجن؟: the prison
السجناء: prisoners
السجين: the prisoner
السحب: clouds
السذاجة: naive
السر: the secret
السرعة: the speed
السرير: the bed
السريع: quick
السعادة: happinese
السفر: travel
السفير: the ambassador
السقوط: the fall
السكارى: drunks
السكر: sugar
السلاجقة: the seljuks
السلاجقة؟: the seljuks
السلاطين: sultans
السلام: peace
السلامة: safety
السلبي: passive
السلجوق: seljuk
السلجوقي: seljuk
السلجوقية: seljuk
السلجوقية؟: seljuk
السلس: smooth
السلسلة: series
السلطان: sultan
السلطان؟: the sultan
السليم: proper
السم: poison
السم؟: poison
السماء: the sky
السماح: allow
السماوي: heavenly
السمكة: the fish
السمو: highness
السن: age
السنوات: the years
السهام: arrows
السهل: easy
السهم: arrow
السهوب: steppe
السهول: plains
السوداء: black
السوق: market
السوق؟: market
السيئة: the bad
السير: bios
السيطرة: the control
السيف: sword
السيوف: swords
الشائعات: rumors
الشاب: the guy
الشاعر: poet
الشاق: hard working
الشاه: the shah
الشاهد: witness
الشباب: young
الشتاء: winter
الشجاع: the brave
الشجاعة: courage
الشجرة: the tree
الشجعان: brave
الشخص: the person
الشخصي: profile
الشديد: serious
الشر: evil
الشر؟: evil
الشرسة: fierce
الشرف: honour
الشرفة: porch
الشعب: the people
الشعر: poetry
الشعلة: the flame
الشعور: feeling
الشفاء: healing
الشفاه: lips
الشقاق: discord
الشقراء: blonde
الشك: doubt
الشكاوى: complaints
الشكل: the shape
الشمس: the sun
الشمس؟: the sun
الشموع: candles
الشهير: famous
الشوارع: streets
الشيء: thing
الشيء؟: the thing
الشياطين: demons
الشيخ: sheikh
الشيخوخة: aging
الشيطان: evil
الشيوخ: the elders
الصالح: the good
الصالحين: righteous
الصباح: the morning
الصباح،: the morning,
الصباح؟: the morning
الصبر: patience
الصبي؟: the boy
الصحابة: companions
الصحارى: deserts
الصحة: the health
الصحيح: the correct
الصحيحة: correct
الصخرة: the rock
الصخور: rocks
الصداقة: the friendship
الصدر: the chest
الصديق: the friend
الصربية: serbian
الصرف: exchange
الصعب: difficult
الصعبة: hard
الصعوبات: difficulties
الصغار: the little ones
الصغر؟: smallness
الصغير: little
الصغير؟: little
الصغيرة: small
الصقور: falcons
الصلاة: prayer
الصلب: steel
الصلة: link
الصلوات: prayers
الصليبي: crusader
الصليبية: crusade
الصليبيون: the crusaders
الصليبيون؟: the crusaders
الصليبيين: crusaders
الصليبيين؟: the crusaders
الصمت: silence
الصهيل: neighing
الصوت: the sound
الصياد: the hunter
الصيد: the hunt
الضالة: stray
الضالين: the lost
الضباب: the fog
الضرائب: taxes
الضغط: pressure
الضلع: the rib
الضوء: the light
الضيف: guest
الضيق: distress
الضيوف: guests
الطابق: floor
الطازج: fresh
الطاعة: obedience
الطاعون: the plague
الطاعون؟: the plague
الطاغية: tyrant
الطاولة: table
الطبالون: drummers
الطبول: drums
الطبيب: the doctor
الطرف: party
الطرق: roads
الطرق؟: roads
الطريق: the path
الطريقة: way
الطعام: the food
الطغاة: tyrants
الطغيان: tyranny
الطفل: child
الطفولة: childhood
الطلاء: paint
الطوعيين: voluntary
الطويل: the long
الطيور: the birds
الظروف: circumstances
الظل: the shadow
الظلام: the darkness
الظهر: the back
العائلة: the family
العاجل: flash
العادات: habits
العادل: fair
العادي: ordinary
العار: shame
العار؟: shame
العاصفة: the storm
العالم: the world
العالم؟: the world
العام: year
العامي: commoner
العاهرة: bitch
العبء: the burden
العبودية: slavery
العبودية؟: slavery
العبيد: slaves
العثور: found
العجين: dough
العدالة: justice
العدالة؟: justice
العدد: the number
العدل: justice
العدو: the enemy
العدو؟: the enemy
العديد: many
العذاب: torment
العراق: iraq
العربة: the cart
العربي: arabi
العرش: the throne
العرف: custom made
العرفي؟: customary
العرق: sweat
العروس: the bride
العريس: the groom
العزيز: dear
العزيز؟: dear
العزيزة: dear
العزيزة؟: dear
العشاء: the dinner
العشاء؟: the dinner
العشائر: clans
العصا: the stick
العصر: age
العصور: ages
العصيبة: stressful
العضات: bites
العظماء: the great ones
العظمى: great
العظيم: great
العظيمة: great
العقبات: obstacles
العقرب: the scorpion
العكس: the opposite
العلاج: treatment
العلاجية: curative
العلم: science
العلوي: top
العم: uncle
العمر: age
العمل: the work
العمل؟: the work
العناء: the trouble
العناد: stubbornness
العناصر: elements
العندليب: nightingale
العواصم: capital cities
العواقب: consequences
العودة: go back
العيد: eid
العيش: live
العين: eye
العينين: eyes
العيون: the eyes
الغابات: forests
الغابة: forest
الغاية: the end
الغباء: stupidity
الغبار: the dust
الغبية: stupid
الغد: tomorrow
الغداء: the lunch
الغداء؟: the lunch
الغذاء: food
الغربان: crows
الغرفة: the room
الغرفة؟: the room
الغرق: drowning
الغزال: spinner
الغزالة: gazelle
الغزو: invasion
الغضب: anger
الغضب؟: anger
الغليان: boiling
الغناء: singing
الغنائم: booty
الغنم: sheep
الغيوم: the clouds
الفأس: ax
الفئران: mice
الفائز: winner
الفاتحة: fatiha
الفاتيكان: vatican
الفارس: the knight
الفاسدين: corrupt
الفتاة: the girl
الفتاة؟: the girl
الفتنة: strife
الفتى: the boy
الفتيات: the girls
الفتيل: the wick
الفجر: daybreak
الفخ: the trap
الفخاخ: traps
الفخر: pride
الفراش: bedding
الفراشات: butterflies
الفرح: joy
الفرس: clicker
الفرسان: knights
الفرصة: the opportunity
الفصائل: factions
الفصل: the classroom
الفعل: verb
الفقار: spondylitis
الفقراء: the poor
الفكر: thought
الفكرة: the idea
الفم: the mouth
الفوج: regiment
الفور: the spot
الفوز: the win
الفوضى: chaos
الفيضان: the flood
الفيلق: legion
الفيلم: the film
الق: acces
القائد: leader
القابلة: midwife
القاتل: the killer
القادة: leaders
القادمة: coming
القاسي: cruel
القاسية: cruel
القاضي: the judge
القاعة: the hall
القاعدة؟: alqaeda
القافلة: the convoy
القامة: tall
القانون: law
القاهرة: cairo
القبائل: tribes
القبر: grave
القبض: capture
القبور: graves
القبيل: like that
القبيلة: the tribe
القبيلة؟: the tribe
القتال: fighting
القتل: the kill
القتلة: the killers
القدامى: the old
القدر: destiny
القدرة: ability
القدس: jerusalem
القدوس: holy
القدوم: arrival
القديم: the old
القديمة: old
القذارة: filth
القذف: ejaculation
القرآن: the quran
القرار: the decision
القرارات: decisions
القران: the quran
القريب: near
القرية: the village
القسطنطينية: constantinople
القسطنطينيه: constantinople
القسوة: cruelty
القصائد: poems
القصة: the story
القصر: the palace
القصر؟: the palace
القصص: stories
القصور: shortcomings
القصيدة: the poem
القصيدة؟: the poem
القصيرة: short
القضايا: issues
القضية: the case
القطعة: widget
القطيع: the flock
القفص: the cage
القلب: the heart
القلعة: the castle
القلق: anxiety
القمامة: garbage
القمة: the top
القمر: the moon
القواعد: the rules
القوافل: caravans
القوة: power
القوس: the bow
القول: to say
القيام: the performance
القيامة: resurrection
القيمة: the value
القيمين: curators
الكابوس: the nightmare
الكاتالونية: catalan
الكاتالونيون: catalans
الكارثة: disaster
الكاردينال: cardinal
الكافر: infidel
الكبرى: great
الكبير: great
الكبيرة: large
الكتاب: the book
الكتاب؟: the book
الكثير: lots
الكثيرة؟: the many
الكرام: distinguished
الكراهية: the hatred
الكرنفال: carnival
الكريم: generous
الكشف: disclosure
الكفاءة: efficiency
الكفار: infidels
الكفاية: enough
الكفوف: paws
الكلاب: dogs
الكلام: talk
الكلب: dog
الكلبة: bitch
الكلمات: the words
الكلمة: word
الكمين: ambush
الكهف: the cave
الكوابيس: nightmares
الكوارث: disasters
اللؤلؤ: pearls
اللا: no
اللاتين: latins
اللازمة: necessary
اللباقة: tact
اللبن: yogurt
اللحاق: catch up
اللحظة: the moment
اللحم: the meat
اللحم؟: the meat
اللحوم: meat
اللسان: the tongue
اللصوص: the thieves
اللصوصية: banditry
اللعاب: saliva
اللعبة: the game
اللعنة: curse
اللعينة: damned
اللغة: the language
الله: allah
الله،: allah,
الله؟: allah
اللهب: flame
اللواء: major general
اللوم: blame
اللون: the color
اللياقة: fitness
الليالي: nights
الليل: night
الليل؟: night
الليلة: tonight
المؤكد: certain
المؤلف: author
المؤمنين: faithful
الماء: water
الماجستير: masters
الماضي: the past
الماضية: the past
الماعز: goat
المال: the money
المالك: owner
المبارز: swordsman
المبارزة: fencing
المبارك: blessed
المباركة: blessed
المبعوث: the envoy
المتاعب: trouble
المتاعب؟: trouble
المتبقية: remaining
المتحاربة: warring
المتعاونين: collaborators
المتغطرسين: arrogant
المتكبر؟: the arrogant
المتمردين: rebels
المتهم؟: accused
المتهمون: accused
المتوسط: average
المجاري: sewer
المجازفة؟: take the risk
المجاعة: famine
المجاعة؟: famine
المجال: the field
المجانين: the crazy ones
المجاورة: neighboring
المجفف: dried
المجففة: dried
المجلس: the council
المجموعة: the group
المجنون: the crazy
المجنونة: crazy
المجهزة: fitted
المجهول: unknown
المجيء: coming
المحارب: the fighter
المحاربين: warriors
المحاكمة: the trial
المحاولة: try
المحتاجين: needy
المحترم: respected
المحترم؟: respected
المحتمل: probably
المحصنة: dungeon
المحصنة؟: dungeon
المحصول: the crop
المحظوظ: the lucky one
المحك: touchstone
المحكمة: court
المحمديون: the mohammedans
المحيط: ocean
المحيطة: surrounding
المخاطر: risks
المخاطرة: risk
المخاوف: concerns
المختصة: competent
المخزي: shameful
المخصص: allocated
المخلصين: loyal
المخيم: the camp
المدان: convicted
المدانين: convicted
المدرسة: school
المدللين: pampered
المدن: the cities
المدينة: city
المرآة: woman
المرآة؟: woman
المرأة: woman
المرات؟: of times
المراس: headache
المراعي: pastures
المراهم: ointments
المراوغات: quirks
المربع: square
المربية: governess
المرة: time
المرتجع: discards
المرتفع: high
المرتفعات: highland
المرتفعات؟: highland
المرجان: coral
المرجل: the boiler
المرجل؟: the boiler
المرح: fun
المرض: the disease
المرضى: the patients
المرور: the traffic
المريرة: bitter
المريض: patient
المريضة: the patient
المزارع: farms
المزيد: more
المسألة: matter
المسؤول: administrator
المساء: evening
المسائل: matters
المساجد: mosques
المسار: track
المساعد: the assistant
المساعدة: help
المسافة: distance
المسافرون: travelers
المستحيل: impossible
المستقبل: the future
المستقبل؟: the future
المستنقع: the swamp
المستنقعات: swamps
المستنقعة: swamp
المستودع: warehouse
المستوى: the level
المسجد: the mosque
المسروقات: loot
المسعور: hydrophobic
المسعورة: rabid
المسكين: poor guy
المسلم: muslim
المسلمة: muslim
المسلمون: muslims
المسلمين: muslims
المسيحي: christian
المسيل: liquefied
المشؤومة: ominous
المشؤومة؟: ominous
المشاعر: feelings
المشاكل: problems
المشاكل؟: problems
المشتبه: suspect
المشتركين: subscribers
المشكلة: the problem
المشكلة؟: the problem
المشنقة: the gallows
المشورة: advice
المشي: walking
المشي؟: walking
المصابيح: leds
المصاعب: hardships
المصير: destiny
المضروب: milled
المضطهدين: the oppressed
المضمون: guaranteed
المضي: go ahead
المطر: the rain
المطلوبة: required
المظلمة: dark
المظلوم: oppressed
المظلومين: oppressed
المعابد: temples
المعابد؟: temples
المعارضة: opposition
المعارك: battles
المعبد: the temple
المعتاد: the usual
المعدن: metal
المعركة: the battle
المعركة؟: battle
المعصم: wrist
المعصمين: wrists
المعلم: the teacher
المعلومات: the information
المغادرة: departure
المغازلة: flirt
المغفرة: forgiveness
المغول: the mongols
المغولي: the mongols
المفتاح: the key
المفترض: supposedly
المفترضين: assumed
المفضل: preferred
المفعول: effect
المفقود: the lost
المفقودين: the missing
المقابلة: the interview
المقاطعة: county
المقبل: next
المقدسة: holy
المقر: headquarters
المقرر: course
المقود: joystick
المكان: place
المكان؟: place
الملحمة: the saga
الملعونين: cursed
الملك: the king
الملكي: royalist
الممتلكات: properties
الممكن: possible
الممنوح: granted
الممنوحة: granted
المميت: deadly
المنابر: platforms
المناجم: mines
المناسب: the appropriate
المناسب؟: the appropriate
المناطق: the regions
المناقشة: discussion
المنال: fetched
المنبر: tribune
المنتج: the product
المنتصر: victor
المنتقم: the avenger
المنخفضة: low
المنزل: home
المنزلية: household
المنسدلة: drop down
المنشود: desired
المنصب: position
المنصب؟: position
المنضدة: the workbench
المنطقة: the region
المنقى: purified
المنوال: loom
المهاجرة: migrating
المهام: mission
المهر: pony
المهم: the important
المهمة: the mission
المهور: ponies
الموافقة: approval
الموت: the death
الموتى: the dead
الموثوق: trusted
الموثوقة: trusted
الموجود: existing
الموصوفة: prescribed
الموضوع؟: subject
الموقعة: signed
الموقف: situation
الميت: dead
النابضة: gating
الناجم: induced
النار: fire
الناس: people
الناس؟: people
النبوءات: prophecies
النبوية: prophetic
النبي: the prophet
النبيل: noble
النتيجة: the result
النجاح: success
النجار: carpenter
النجوم&quot;: stars&quot;
النجوم: stars
النحاسية: brass
النحل: bees
النزل: the hostel
النزيف: bleeding
النزيف،: bleeding,
النساء: women
النسر: the eagle
النسور: the eagles
النسيج: fabric
النصر: victory
النظر: look
النظيفة: clean
النقاط: points
النقطة: the point
النقي: pure
النقية: pure
النماذج: forms
النهائي: final
النهائية: the final
النهاية: the end
النهاية؟: the end
النوع: type
النوم: sleep
النية: intention
النيران: flames
النيل: nile
اله: god
الهادئ: the pacific
الهارب: fugitive
الهاربين: fugitives
الهجرة: immigration
الهجرة؟: immigration
الهجوم: attack
الهدايا: gifts
الهدوء: quiet
الهدوء؟: quiet
الهدير: growl
الهرب: run away
الهروب: escape
الهلال: crescent moon
الهمجيات: barbarities
الهمسات: whispers
الهواء: the air
الهوية: identity
الهيئات: organizations
الهيئات؟: organizations
الهيئة: commission
الهيكل: the structure
الهيل: cardamom
الواجب: duty
الواضح: obviously
الواقع: indeed
الوجبات: meals
الوجه: the face
الوجهة: destination
الوجود: presence
الوحش؟: the monster
الوحيد: the only
الوحيدة: the only one
الوداع: goodbye
الوراء: backwards
الورود: roses
الوزير: the minister
الوزير؟: minister
الوصول: access
الوضع: situation
الوضع؟: the situation
الوطن: motherland
الوظائف: functions
الوعد: the promise
الوعي: awareness
الوفاء: fulfillment
الوفاض: handover
الوقاحة: insolence
الوقت: time
الوقوف: stand up
الولاء: loyalty
الولادة: birth
الولد: the boy
الى: to
الي: to me
اليأس: despair
الياس: despair
اليد: hand
اليدين: hands
اليسار: the left
اليمنى: right
اليمين: right
الينابيع: springs
اليه: mechanism
اليه؟: mechanism
اليها: to her
اليوم: today
اليوم؟: today
اليومين: the two days
اليونانية: greek
امتحان: exam
امتدت: stretched
امتنان: gratitude
امرأة: a woman
امرأة؟: a woman
امسح: wipe
امسك: catch
امسكه: hold it
امك: your mother
امنحهم: give them
امي: mom
امي؟: mom
امير: prince
اميرتي: my princess
ان: that
انا: i am
انت: you are
انتشر: mushroom
انتظار: waiting
انتظارك: waiting for you
انتظاركم: waiting for you
انتظارنا: waiting for us
انتظاره: waiting for him
انتظر: wait
انتظرت: i waited
انتظرتك: i waited for you
انتقام: revenge
انتقل: he moved
انتهت: expired
انتهوا: they finished
انتهوا؟: they finished
انتهى: is over
انتهيت: i am done
انجر: run away
انحنى: bend over
انخفضت: decreased
انسكاب: spillage
انسكب: spilled
انشغال: busyness
انصت: listen
انطاكية: antioch
انطاكيه: antioch
انطلق: go ahead
انطلقت: launched
انطلقنا: we set off
انظر: look
انظروا: look
انظري: see
انعكاس: reflection
انفجار: explosion
انقذ: save
انقرض: become extinct
انه: it's a
انها: it
انهض: stand up
انهم: that they
اني: i am
اهتم: take care
اهدأ: just chill
اهدئي: calm down
اهرب: run away
اهلا: welcome
او: or
اوجوز: oguz
اوز: geese
ايجيت: egit
ايزادورا: isadora
ايضا: also
اين: where
ايها: hey
بأحد: by one
بأحلامك: with your dreams
بأخرى: with another
بأخيك: with your brother
بأذني: with my ear
بأذى: hurt
بأربعة: by four
بأس: okay
بأستعجال: urgently
بأسره: the whole
بأكملها: whole
بأم: mother
بأمان: safely
بأمر: by order
بأن: that
بأنفسنا: by ourselves
بأنفسهم: their own
بأنك: that you
بأنه: that
بأي: ebay
بأيدينا: with our own hands
بإبادة: exterminating
بإذن: with permission
بإذنكم: with your permission
بإعداد: set up
بإمكانك: you can
بإنشاء: creates
بإنهاء: quit
باب: door
بابنا: our door
بابنه: with his son
بابي: babi
باحترام: respectfully
باختبار: tested
باختصار: briefly
بارك: park
باستثناء: except
باستمرار: continuously
باسم: basim
باسمك: in your name
باسمي: in my name
باسي: passy
باطلة: void
باعتذار: apologize
باكي؟: crying
بالآلاف: in the thousands
بالأرض: to the ground
بالأسف: sorry
بالأمر: it is
بالإعداد: set up
بالإيمان: by faith
بالاكتئاب: depressed
بالانتقام: with revenge
بالباب: by the door
بالبرد: cold
بالبقاء: to stay
بالتأكيد: sure
بالتاكيد: definitely
بالتجول: run around
بالترتيب: in the order
بالتضحية: to sacrifice
بالتضور: to attend
بالتفصيل: in detail
بالتمسك: stick to
بالتنقيط: drip
بالجسم: the body
بالجلوس: to sit
بالجنود: soldiers
بالحديث: speaking
بالحراس: with guards
بالحزن: sad
بالحياة: in life
بالحيرة: perplexed
بالخجل: ashamed
بالخروج: get out
بالخوف: scared
بالخير: well
بالخيول: with horses
بالدخول: to enter
بالدم: with blood
بالذعر: panicked
بالرحيل: go
بالرحيل؟: going
بالرغاوي: foams
بالرقم: number
بالركب: up
بالريبة: suspiciously
بالسجن؟: imprisoned
بالسفر: to travel
بالسلاح: with weapons
بالسلطان: with sultan
بالسلطة: with power
بالسيوف: with swords
بالشجاعة: with courage
بالصبر: be patient
بالصخور: with rocks
بالصمت: in silence
بالضبط: exactly
بالضيق: upset
بالطبع: of course
بالطبيب: by a doctor
بالعديد: with many
بالعطاء: to give
بالعودة: go back
بالعين: by eye
بالفرار؟: fleeing
بالفعل: indeed
بالقرب: near
بالقلق: worried
بالقوة: by force
بالكثير: with a lot
بالكراهية: with hatred
بالله: by allah
بالمغادرة: to leave
بالمكان: place
بالملل: bored
بالمنزل: at home
بالمهمة: mission
بالنجوم: astral
بالنسبة: for
بالنظر: by looking
بالنفس: by self
بالوظائف: functions
بامسي: bamsey
بانتباه: closely
باهظا: high
باي: ebay
باي؟: bai
بايبورا: pipora
بايز: bayes
ببطء: slowly
بتثبيته: install it
بتحرير: edit
بتحميل: to download
بتحميله: download it
بتدريبها: train them
بتروتشيو: petruccio
بتروتشيو؟: petrucio
بتزويره: forged
بتسليم: deliver
بتسليمه: hand it over
بتشغيل: playback
بتطبيقه: apply it
بتعيين: set
بتكريمها: honored
بتنظيف: clean up
بتنظيم: organized
بتوصيل: connect
بتوقعاتك: to your expectations
بثلاث: by three
بثلاثة: with three
بجانب: next to
بجانبه: beside him
بجانبي: beside me
بجبال: with mountains
بجد: hard
بجدية: seriously
بجعة: swan
بجمالها: its beauty
بجمع: collects
بجمعهم: collect them
بجوار: next to
بجيشه: with his army
بحاجة: need
بحاجه: i need it
بحجر: with a stone
بحجم: size
بحر: sea
بحرية: free
بحسن: well
بحق: rightly
بحلول: by
بحملها: to carry
بحياتك: with your life
بحياتنا: in our lives
بحياته: with his life
بحياتين: for two lives
بحيث: in which
بختم: with a seal
بخطأ: by mistake
بخطف: by kidnapping
بخلاف: other than
بخلافك: other than you
بخلافك؟: other than you
بخير: fine
بخير؟: fine
بد: must
بدأ: seem
بدأت: started
بدأنا: we started
بداخلك: inside you
بداخلها؟: inside it
بداخلي: inside of me
بدعم: powered
بدلا: instead of
بدلاً: instead of
بدمه: with his blood
بدورنا: our turn
بدوره: turn
بدون: without
بدونك: without you
بدونهم؟: without them
بذر: sowing
بذلك: so
بذلك،: so,
بذلك؟: so
بذور: seeds
برأيك: in your opinion
براحة: comfortably
برافو: bravo
بركتك: your blessing
بركته: his blessing
بركتي: my blessing
برمه: screw
برنر: berner
بري: wild
بريء: innocent
بريئة: innocent
برية: wilderness
بريق: luster
بسبب: because
بسببك: because of you
بسببنا: because of us
بسببه: because of him
بسببهم: because of them
بسببي: because of me
بسرعة: quickly
بسرية: confidentially
بسعادة: happily
بسفينة: by ship
بسكين: with a knife
بسلام: safely
بسلطان: with sultan
بسم: in the name of
بسهولة: easily
بسيفه؟: with a sword
بشأن: about
بشأنه: about it
بشؤونك: about your affairs
بشبابك: with your youth
بشخص: someone
بشدة: badly
بشرة: skin
بشرف: with honor
بشكل: formally
بصحة: healthy
بصراحة: honestly
بصرف: exclusively
بصعوبة: with difficulty
بصمت: silently
بضائعنا: our goods
بضائعه: his goods
بضاعتي: my goods
بضع: a few
بضعة: a few
بطريقة: in a way
بطل: a hero
بعائلتك: your family
بعبارة: with the words
بعث: he sent
بعد: after
بعد؟: distance
بعدك: after you
بعدهم: after them
بعدي: after me
بعض: some
بعضنا: each other
بعضها: some of them
بعضهم: some of them
بعمق: deeply
بعملك: with your work
بعناية: carefully
بعون: with the help
بعيد: far
بعيدا: away
بعيدا؟: away
بعيداً: away
بعيدة: far
بعيدة؟: far
بعيدًا: away
بغداد: baghdad
بغزال: gazelle
بغضب: angrily
بـ: with
بفارغ: empty
بفتح: open
بفضل: thanks to
بفكرة: with an idea
بفناء: patio
بقايا: remains
بقبيلتنا: by our tribe
بقتل: to kill
بقتلنا: to kill us
بقتله؟: to kill him
بقدر: as much
بقراره: his decision
بقضيب: with a rod
بقعة: spot
بقلق: anxiously
بقوا: they stayed
بقوة: strongly
بقول: bean
بقيمة: worth
بقينا: we stayed
بك: your
بك؟: your
بكثير: much
بكس: bcs
بكل: all
بكم: how much
بل: but
بلا: without
بلاء: affliction
بلادي: my country
بلحظة: in an instant
بلدنا: our country
بلدي: my country
بلطف: nicely
بلمس: touch
بلى: yes
بما: including
بمثل: similarly
بمجرد: once
بمساعدة: assisted
بمساعدتكم: with your help
بمساعدتي: with my help
بمشاكل: with problems
بمطاردة: chasing
بمفردك: on your own
بمفردنا: on our own
بمفرده: on his own
بمكان: very much
بن: the son of
بنا: coffee beans
بناء: building
بنات: daughters
بناتي: girlie
بنار: with fire
بنت: girl
بنت؟: girl
بنفسك: by yourself
بنفسه: by himself
بنفسه؟: by himself
بنفسي: by myself
بنهاية: by the end
بنوعه: its kind
بنى: brouwn
بنى،: brouwn,
بني: brouwn
بني؟: brouwn
به: with it
به،: with it,
به؟: with it
بها: out
بهدوء: quietly
بهذا: by this
بهذه: by this
بهم: their
بهم؟: their
بوابة: gate
بواسطة: by
بواسطتك: by you
بوزوك: bozuk
بوصولك: upon your arrival
بوضوح: clearly
بوعدي: my promise
بوقت: time
بولو: polo
بومان: bowman
بي: b.
بي؟: me
بياناتي: my details
بيبورا: pepora
بيبورا؟: pepora
بيت؟: a house
بيتاً: a house
بيتروتشيو: petruccio
بيدق: pawn
بيدي: with my hands
بيديك: with your hands
بيرك: burke
بيريك: berek
بيسول: bessol
بيضاء: white
بيع: sale
بيك: peck
بيلج: bilge
بين: between
بينما: while
بيننا: between us
بيوتنا: our homes
بييس: bess
تأتي: come
تأجيج: kindle
تأخذ: take
تأخذك: take you
تأخذه: take it
تأخذهم: take them
تأخر: lateness
تأخرت: delayed
تأخرت؟: delayed
تأخرنا: we are late
تأخروا: they are late
تأخير: delay
تأرجح: swing
تأسست: was established
تأكد: make sure
تأكل: eat
تأكل؟: eat
تأكيد: emphasis
تألق: shine on
تأهب: preparedness
تؤمن: believe
تابع: follow
تاجر: dealer
تاجرًا: merchant
تاركا: leaving
تاركين: leaving
تاريخنا: our history
تافه: trifle
تاقينا: we missed
تبادل: exchange
تبارك: blessed
تباركنا: bless us
تباركهم؟: bless them
تبالغ: exaggerate
تبتسم: you smile
تبتعد: move away
تبحث: looking
تبدأ: start
تبدو: look
تبدوون: you look
تبدى: look
تبدين: you look
تبشر: herald
تبقى: stay
تبقي: stay
تبقيها: keep it
تبكي: crying
تبهر: dazzle
تبين: turns out
تتأذى: get hurt
تتأرجح: oscillating
تتأكد: be sure
تتألق: shine
تتألم: it hurts
تتالم؟: suffer
تتجول: walk around
تتحالف: allied
تتحدث: you talk
تتحرر: free
تتحرك: moving
تتحسن: getting better
تتحول: turn out
تتخلى: give up
تتدفق: flowing
تتذكر: you remember
تتذكرني: you remember me
تتردد: hesitate
تترك: leave
تتركنا: leave us
تتزوج: get married
تتساءل: she wonders
تتصدع: cracking
تتصرف: behave
تتصل: relate
تتضرر: be hurt
تتضور: you are attending
تتعارض: incompatible
تتعافى: recovering
تتعامل: deals
تتعب: tired
تتعرض: exposed
تتعطل: crashes
تتعلم؟: you learn
تتغير: are changing
تتفاخر: brag
تتفوق: excel
تتكلم: she speaks
تتم: are done
تتمكن: you can
تتمنا: wishes
تتمنى: wish
تتنفس: breathe
تتهم: accuse
تتوسل: pleading
تتوق: yearning
تتوقع: expect
تتوقع؟: expect
تتوقف: stop
تتويج: coronation
تثرثر: gossip
تثق: you trust
تثير: excite
تجار: dealers
تجاوز: transcend
تجاوزت: exceeded
تجاوزنا: we passed
تجتذب: attract
تجد: you find
تجده: you find it
تجدهم: you find them
تجذب: attract
تجرؤ: dare
تجرؤ؟: you dare
تجعل: make
تجعلك: make you
تجعلنا: make us
تجعلني: makes me
تجعله: make it
تجف: dry out
تجلب: bring
تجلس: sit down
تجنب: avoid
تجنيب: spare
تجنيبنا: spare us
تجنيبي: spare
تجنيد: recruitment
تجنيدهم: recruited
تجول: wandering
تحافظ: maintains
تحاول: try
تحب: love
تحبه: you love him
تحت: under
تحتاج: need
تحترق: burning
تحترم: respectful
تحتفظ: retain
تحثني: urging me
تحداني: challenge me
تحدث: talk
تحدثت: she spoke
تحدثنا: we talked
تحدد: determined
تحديد: determination
تحذير: warning
تحذيرنا: our warning
تحرر: liberation
تحرق: burns
تحرقك: burn you
تحرك: move
تحرير: release
تحزن: be sad
تحصل: obtain
تحضر: you prepare
تحضره: you bring it
تحطم: has crashed
تحظى: have
تحفظهم: their reservation
تحقق: check
تحقيق: investigation
تحقيقه: achieve
تحكم: controller
تحل: solved
تحلق: flying
تحمل: bearing
تحملت: i endured
تحمله: afford it
تحميل: download
تحني: bend
تحول: transformation
تحولت: turned
تحولوا؟: they turned
تحويل: transformation
تحيات: greetings
تحياتهم: greetings
تحياتي: greetings
تحية: greeting
تحير: boggle
تخاطر: telepathy
تخاف: afraid
تخافوا: be afraid
تخبر: you tell
تخبرنا: tell us
تخبرني: you tell me
تخبره: you tell him
تخبرها: tell her
تختبر: tests
تختبر؟: tests
تختفي: disappear
تخجل: ashamed
تخذل: let down
تخذلني: let me down
تخرج: graduation
تخسر: you lose
تخضع: subject
تخطط: planning
تخف: fear
تخفف: loosen up
تخفي: hide
تخفيف: mitigation
تخفيه: hide it
تخفيها: hide it
تخلص: get rid
تخليت: i gave up
تخون: betray
تخيفني؟: scare me
تدافع: stampede
تدخر: spare
تدخل: intervention
تدع: let not
تدعم: supports
تدعنا: let us
تدعني: let me
تدعها: let her
تدعي: she claims
تدفع: you pay
تدفن: buried
تدمير: destruction
تدور: spin
تذرف: shedding
تذكر: remember
تذكيرها: remind her
تذهب: you go
تذهب،: you go,
تذهب؟: you go
تذوب: melt
تر: tr
ترأس؟: head
تراني: you see me
تراه: you see it
ترتاح: rest
ترتجف: trembling
ترتعش: shaking
ترتيب: arrangement
ترجعوا: come back
ترجمة: translation
ترحيب: welcome
ترحيبا: welcome
ترحيل: relay
تردد: frequency
ترسل: send
ترغب: wish
ترفع: flying
ترقيته: upgraded
ترك: leave
تركت: i left
تركتك: i left you
تركتها: i left it
تركض: you run
تركك: leaving you
تركم: accumulation
تركمان: turkmen
تركماني: turkmen
تركه: leave him
تركها: leave it
تركهم: leave them
ترمي: throw
ترميها: throw it
ترني: you show me
ترهم: you see
ترويض: taming
ترويضها: tamed
ترى: see
تريد: you want
تريد؟: you want
تريده: you want
تريدين: you want
تزال: still
تزعج: disturb
تزعجني: disturb me
تزن: weigh
تزوجك: he married you
تزوجها: marry her
تزوره: you visit
تسأله: you ask him
تساعد: help
تساعدنا: help us
تسامحنا: our tolerance
تسبب: it causes
تسببت: caused
تسبق: precede
تسبقك: precedes you
تسبقها: precedes it
تستحق: well worth
تستحقه: you deserve it
تستخدم: used
تسترد: recover
تستريح: resting
تستسلم: give up
تستطع: you can
تستطيع: could you
تستعد: preparing
تستعيد: regain
تستقر: settle down
تستمر: continue
تستمع: she listens
تسرب: leak
تسعة: nine
تسعى: seeking
تسفك: shed
تسقط: falling off
تسكن: inhabit
تسلل: sneak
تسللت: crept
تسليم: delivery
تسليمهم: hand them over
تسمح: allow
تسمع: you hear
تسمعني: hear me
تسمعه: hear it
تسمعها: you hear it
تسمعهم؟: you hear them
تسمم: toxicity
تسمون: you call
تسمونه: you call it
تسمى: it's called
تسمي: it's called
تسمية: naming
تسمين: fattening
تسهب: dwell
تسوية: settlement
تسيطر: controlled
تشاء: you like
تشارك: involved
تشتعل: ignite
تشرب: drink
تشرفت: nice to meet you
تشعر: feel
تشعري: you feel
تشغيل: operation
تشغيله؟: play it
تشك: thx
تشكل: form
تشكو: complaining
تشنجات: cramps
تشنجاتي: cramps
تشير: suggest
تصاب: you get infected
تصادف: encounter
تصارع: wrestling
تصبح: become
تصبر: patience
تصدق: incredible
تصديق: ratification
تصر: insists
تصرخ: scream
تصريح: declaration
تصف: describe
تصل: reach
تصلي: you pray
تصمت: shut up
تصنع: manufactured
تصوير: take photo
تضايق: harass
تضحي: sacrifice
تضحية: sacrifice
تضخمت: swelled
تضرب: hit
تضربنا: beat us
تضربه: hit him
تضطر: have to
تضع: put
تضيء: light up
تضيع: get lost
تضيع؟: get lost
تطرح: pose
تطغى: overwhelm
تطلب: ask
تطمئن: rest assured
تطور: has evolved
تطورات: developments
تطير: fly
تطيع: obey
تطيعنا: obey us
تظن: you think
تظهر: appear
تعارض: conflict
تعارضوا: they collided
تعافت: she recovered
تعافى: recovered
تعافى؟: recovered
تعاقب: succession
تعال: come
تعالى: come
تعامل: deal
تعاملني: treat me
تعاني: suffer
تعاونت: teamed up
تعاونوا: cooperate
تعبئة: fill
تعبت: get tired
تعبس: frown
تعتاد: get used to
تعترف: recognize
تعتقد: u think
تعتمد: depends
تعتني: take care
تعثرت: stumbled
تعجن: kneaded
تعذب: torture
تعذيب: torture
تعذيبا: tortured
تعرض: exposure
تعرضت: exposed
تعرضوا: they were exposed
تعرف: know
تعرف؟: you know
تعرفني: do you know me
تعرفها: you know
تعرفهم: you know them
تعض: bite
تعط: give
تعطهم: give them
تعطى: given
تعطي: give
تعطيك: give you
تعطينا: give us
تعطيني: give me
تعفننا: our rot
تعفيني: my exemption
تعقيدا: complicated
تعلم: learn
تعلمت: i learned
تعلمت؟: i learned
تعلمته: learned it
تعلمتها: i learned it
تعلمنا: we learned
تعلمه: learn it
تعلموا: have learned
تعلمون: you know
تعليق: suspension
تعمل: working
تعود: return
تعوض: compensate
تعيدني: take me back
تعيدها: give it back
تعيش: live
تعيشها: live it
تعيين: designation
تعيينه: set it
تغادر: she leaves
تغار: jealous
تغتفر: forgive
تغذي: feed
تغرب: set
تغرق: sink
تغضب؟: get angry
تغضبني: anger me
تغطي: covering
تغلب: get over
تغلبت: overcame
تغلبوا: overpower
تغلق: shuts down
تغمض: close
تغمغم: mumbles
تغيير: a change
تفرح: rejoice
تفرق: divide
تفسدها: spoil it
تفسير: explanation
تفضل: please enter
تفعل: are doing
تفعل؟: are doing
تفعله: you do
تفعله؟: you do
تفقد: you lose
تفكر: contemplate
تفكيك: dismantling
تفهم: understand
تفهم؟: understand
تفهمنى؟: understand me
تفهمني: understand me
تفهمني؟: understand me
تفهمين: understand
تفوتني؟: miss me
تفي: meet
تقابل: meet
تقاتل: fight
تقارن: coupling
تقاضيني: take me
تقاليدنا: our traditions
تقاوم: resist
تقبل: accept
تقبله: accept it
تقترح: suggests
تقترحون؟: do you suggest
تقتل: kill
تقتل؟: kill
تقدم: progress
تقديم: submit
تقرر: decide
تقريبا: approximately
تقريباً: approximately
تقريرا: report
تقسم: spliced
تقسيم: division
تقصد: you mean
تقطعت: stranded
تقع: located
تقف: stand
تقل: less
تقلق: worry
تقنعه: convince him
تقود: lead
تقودنا: lead us
تقول: says
تقول؟: says
تقوله: you say
تقوم: get up
تقيدوني؟: tied me
تقيم: assess
تكذب: you lie
تكرهني: you hate me
تكسير: cracking
تكشف: reveal
تكفي: enough
تكلم: speak
تكليف: assigned
تكن: not
تكون: be
تكوين: formation
تلاحظ: notes
تلاشت: faded
تلاوة: recitation
تلبي: meet
تلتئم: healed
تلتقي: she meets
تلد: give birth
تلعب: play
تلعن: cursed
تلقيناها: we received it
تلك: that
تلمح: hint
تلمس: touch
تلمسها: touch it
تلو: after
تلوم: blame
تلومني: blame me
تلوّح: waving
تليق: fitting
تم: done
تماما: completely
تمامًا: completely
تمبلر: templar
تمبلر؟: templar
تمبلس: temples
تمت: done
تمتلكه؟: own it
تمتنع: refrain
تمجيد: glorification
تمحى: erased
تمر: pass
تمرض: you get sick
تمزق: rupture
تمسك: stuck
تمشي: she walks
تمكنا: we managed
تمكنت: i managed
تمنحهم: give them
تمنياتي: my wishes
تموت: you die
تموت؟: you die
تميزك: distinguish you
تناسب: suits
تناقضا: contradiction
تنام: you sleep
تناول: eat
تناولت: ate
تناولنا: we ate
تنتظر: waiting
تنتظرنا: waiting for us
تنتقل: move
تنتقم: retaliate
تنته: over
تنتهك: violate
تنتهي: expires
تنجح: succeed
تنحدر: stoop
تنحني: bow down
تنخفض: go down
تندم: you regret
تنزلق: slip
تنس: tennis
تنسى: forget
تنطلق: tripping off
تنظر: look
تنظيف: cleaning
تنظيمه: organize it
تنفد: run out
تنفست: breathe
تنفصل: separated
تنفق: spend
تنفيذ: implementation of
تنفيذها: implemented
تنقذ: save
تنقذني: save me
تنقذهم: save them
تنقذهم؟: save them
تنقل: navigate
تنكسر: break
تنم: sleep
تنمو: grow
تنوي: intend
تنين: dragon
تهاجر: migrate
تهاجم: attacks
تهاجم؟: attacking
تهالك: worn out
تهب: blowing
تهتم: care
تهتم؟: care
تهدأ: calm down
تهدئة: calm down
تهدئتهم: calm them down
تهددنى؟: threaten me
تهدف: aims
تهديد: a threat
تهديدا: threat
تهرب: evade
تهز: shaking
تهمني؟: interested
تواجه: facing
تواجهه: facing
تواجهها: faced
تواطأت: colluded
توجد: exist
توجرول: tugrul
تود: todd
تورجوت: turgut
تورجوت؟: turgut
تورغت: torget
تورغوت: turgut
توصلت: reached
توغرول: tugrul
توفي: died
توقع: expect
توقعا: predictably
توقعاتك: your expectations
توقف: stop
توقف،: stop,
توقفت: i stopped
توقفنا: we stopped
توماس: thomas
تويغار: twigar
تيأسوا: they despair
تيار: stream
تيبيسي: tepesi
تيبيسي؟: tipisi
تيتوس: تيتوس
تيتوس؟: titus
تيطس: titus
ثانية: a second
ثروة: wealth
ثريًا: chandelier
ثعبان: a snake
ثق: trust
ثقب: hole
ثقة: confidence
ثقيلا: heavy
ثلاثة: three
ثم: then
ثماني: eight
ثمرة: fruit
ثمرته: its fruit
ثمن: price
ثمنا: a price
ثمنها: its price
ثني: drape
ثوان: seconds
جئت: i came
جئنا: we came
جاء: came
جاءت: she came
جاءوا: they came
جائع: hungry
جافة: dry
جالس: sitting
جالسًا: seated
جانب: side
جانبكم؟: your side
جانبنا: our side
جانبه: his side
جانبي: side
جاهز: ready
جاهز؟: ready
جاهزة: ready
جاهزًا: ready
جبال: mountains
جبل: mount
جبناء: cowards
جبنه: cheese
جثة: dead body
جثث: corpses
جد: grandfather
جدا: very
جدا؟: very
جداً: very
جدك: your grandfather
جده: grandmother
جدولهم: their schedule
جدي: grand
جديد: new
جديدة: new
جديدًا: new
جديلة: cue
جدًا: very
جدًا؟: very
جذوري: my roots
جراحية: surgical
جربت: i tried
جرح: wound
جرحك: your wound
جرحها: wound her
جرف: cliff
جروحك؟: your wounds
جروحه: his wounds
جريح: wounded
جريمة: a crime
جزءًا: part
جزانفر: jazzanfar
جزيلا: so much
جسمك: your body
جعل: make
جعلت: made
جعلتنا: you made us
جعلته: i made it
جعلك: made you
جعلنا: made us
جعله: make it
جعلها: make them
جعلوا: they made
جففوا: they dried
جلادًا: hangman
جلب: had brought
جلبت: brought
جلبنا: we brought
جلده: his skin
جماعة: group
جمال: beauty
جمالك: your beauty
جمالها: its beauty
جمع: plural
جمعت: collected
جميع: all
جميعا: all of them
جميعاً: all of them
جميعهم: all of them
جميعًا: all of them
جميل: nice
جميلة: beautiful
جناحيها: wingspan
جنب: side
جنبا: side
جنبًا: side
جنة: paradise
جندي: soldier
جنديًا: a soldier
جننت؟: mad
جنود: soldiers
جنوداً: soldiers
جنودك: your soldiers
جنون: madness
جهة: side
جهودك: your efforts
جوابه: his answer
جواسيسهم: their spies
جوعا: starvation
جوعاً: starvation
جوعك: your hunger
جوعًا: starvation
جوكسي: juxi
جوناس: jonas
جوندوجدو: gonddudu
جوندوجو: جوندوجو
جوندوجو؟: gundogo
جوهرة: jewel
جيا: jia
جياسين: giacin
جيد: good
جيد؟: good
جيدا: well
جيدا؟: well
جيدة: good
جيدة؟: good
جيدًا: well
جيران: neighbors
جيرانهم: their neighbors
جيش: army
جيشا: an army
جيلاني: gilani
جيوشنا: our armies
جيوشًا: armies
جيوفاني: giovanni
جيوفاني؟: giovanni
حاجة: need
حاجتنا: our need
حاربت: i fought
حارس: guard
حارسا: a guard
حافظت: maintained
حال: case
حالة: status
حالته: his condition
حالتها: her condition
حالك: are you
حالك؟: are you
حاله: status
حاله؟: status
حامل: pregnant
حان: it's about
حاول: try to
حاولت: i tried
حاولنا: we tried
حاولوا: they tried
حاييم: chaim
حب: love
حبس: imprisonment
حبك: crochet
حبل: rope
حبه: grain
حبها: her love
حبي: my love
حبيب: lover
حبيبة: a girlfriend
حبيبتك: your sweetheart
حبيبتي: my love
حبيبتي؟: my love
حبيبك: your lover
حبيبي: baby
حتى: until
حثالة: scum
حجر: stone
حجرًا: stone
حد: limit
حدة: sharpness
حدث: happen
حدث؟: happen
حدث؟،: happen
حدثت: updated
حددناه: we defined it
حدسًا: intuition
حدوث: happening
حدود: border
حدودنا: our borders
حدودهم: their limits
حديث: modern
حديد: iron
حديقة: garden
حذرا: careful
حذرتك: i warned you
حذرتم: you warned
حذرني: warned me
حذرين: careful
حرا: free
حرارته: his temperature
حراس: guards
حرة: free
حرجة: critical
حرر: freedom
حرفي: literal
حرق: burn
حركة: movement
حريري؟: silky
حريص: careful
حريصا: careful
حريصة: eager
حريق: fire
حزامك: your belt
حزم: strap
حزمة: package
حزن: sadnes
حزنك: your grief
حزننا: our grief
حزين: sad
حزينا: sad
حساب: an account
حساسة: sensitive
حسب: according
حسن: حسن
حسنا: ok
حسنا؟: ok
حسناً: ok
حسناً؟: ok
حسنًا: ok
حشد: crowd
حصان: horse
حصانه: immunity
حصاني: my horse
حصر: inventory
حصل: happened
حصلت: i got
حصن: fort
حصنه: his fort
حصني: my fortress
حطمت: shattered
حطمهم: smashed them
حظ: luck
حفرة: pit
حفرت: dug
حفظ: save
حفظته: you saved it
حفظك: saved you
حفظه: save it
حفظها: save them
حفل: party
حفلات: parties
حفيد: grandson
حفيداً: grandson
حفيدنا: our grandson
حق: right
حق؟: right
حقا: oh really
حقا؟: oh really
حقاً: oh really
حقي: my right
حقيبة: a bag
حقيقة: reality
حقيقي: real
حقيقية: real
حقيقية؟: real
حقيقيين: real
حقيقيًا: real
حقًا: oh really
حقًا؟: oh really
حكم: rule
حكمة: wisdom
حكيما: wise
حكيمة: wise
حل: solution
حلايم: halayim
حلاً: a solution
حلب: aleppo
حلب؟: aleppo
حلفاء: allies
حلق: throat
حلقة: ring
حلقك: your throat
حلقه: ring
حلقي: annular
حلم: dream
حلما: a dream
حلمي: my dream
حلها: solve it
حلوة: sweet
حلولهم: their solutions
حلوه: sweet
حليم: حليم
حليم؟: حليم؟
حليمة: halima
حليمي: papillary
حليمي؟: papillary
حمار؟: donkey
حماقاتك: your fools
حمامة: pigeon
حماية: protection
حمايته: protect him
حمايتهم: protect them
حمزة: حمزة
حمل: pregnancy
حملة: campaign
حمى: fever
حمىته: fever him
حناجرنا: our throats
حواجبها: her eyebrows
حواسك: your senses
حول: around
حولك: around you
حولنا: around us
حولها: around
حي: neighborhood
حيا: alive
حيا؟: alive
حياة: life
حياتك: your life
حياتك؟: your life
حياتنا: our life
حياته: his life
حياتهم: their lives
حياتي: my life
حياً: alive
حية: vivid
حيث: where
حيدر: haider
حيل: tricks
حين: when
حيوانات: animals
خائف: horrified
خائف؟: horrified
خائفا: frightened
خائفا؟: frightened
خائفة: scared
خائن: traitor
خائنا: traitor
خائنا؟: traitor
خائناً: traitor
خاتون: hatun
خاتون؟: خاتون؟
خادم: servant
خادمة: maid
خادمه: maid
خارج: outside
خاص: special
خاصة: especially
خاطئ: wrong
خاطئا؟: wrong
خاطر: risk
خاطرت: i risked
خالص: pure
خالي: empty
خان: khan
خانوا: they betrayed
خبر: news
خبرا: a news story
خبرة: experience
خبز: bread
خبزها: bake it
ختم: seal
خداع: tricked
خدم: servants
خدمات: services
خدماتك: your services
خدمة: service
خدمتك: serve you
خذ: take
خذنا: take us
خذه: take him
خذها: take it
خذها،: take it,
خذهم: take them
خذيه: take it
خرافات؟: myths
خرافنا: our sheep
خرج: went out
خرجت: i went out
خروفك: your sheep
خريطة: a map
خشب: wood
خصبة: fertile
خصلة: tress
خصوصا: especially
خضراء: green
خط: line
خطأ: error
خطأك: your fault
خطايا: sins
خطب: sermon
خطة: plan
خطتنا: our plan
خطر: danger
خطط: plans
خطف: kidnapping
خطفوها: they kidnapped her
خطوة: a step
خطورة: danger
خطيئة: sin
خطير: dangerous
خطيرا: serious
خطيرة: serious
خفيف: light
خلاص: stop
خلاف: dispute
خلال: during
خلالك: through you
خلدك: immortalize you
خلصت: concluded
خلفك: behind you
خلفه؟: behind him
خلق: create
خلقت: created
خلقتها: i created it
خلقوا: they created
خليفة: successor
خليفتك: your successor
خمسة: five
خنجر: dagger
خوارزم: khorezm
خوارزمشة: algorithm
خوفي: my fear
خياران: two options
خيام؟: tents
خيامنا: our tents
خيانة: betrayal
خيبة: disappointment
خير: good
خيمة: tent
خيمتك: your tent
خيمتك؟: your tent
خيمتنا: our tent
خيمته: his tent
خيمته؟: his tent
خيمتهم: their tent
خيمتي: my tent
خيمتي؟: my tent
خيولنا: our horses
خيولهم: their horses
خُطف: kidnapping
دائما: always
دائمة: always
دائمة؟: always
دائمًا: always
داخل: inside
داخل؟: inside
داخلك: inside you
داخلنا: within us
داخلي: internal
داعي: caller to
دافئ: warm
دامت: as long as
داهم: raid
داهمت: raided
داوجثير: daugther
داوود: david
دب: bear
دبس: molasses
دخانية: smokeless
دخل: enter
دخلت؟: entered
دخوله: entering it
دربتها: i trained her
درجة: degree
درس: study
درويش: darwish
دع: let
دعا: call
دعاه: called him
دعم: support
دعمك: your support
دعنا: let's
دعنى: let me
دعني: let me
دعه: let him
دعها: let her
دعوت: i called
دعوتني: you called me
دعونا: we invited
دفع: pay
دفعت: paid
دفن: burial
دفنت: i was buried
دفنهم: bury them
دقائق: minutes
دليل: evidence
دليلي: dalili
دم: blood
دماء: blood
دمائنا: our blood
دمائهم: their blood
دماغك: your brain
دمرت: destroyed
دمشق: damascus
دمك: your blood
دمك؟: your blood
دمنا: our blood
دموع: tears
دموعنا: our tears
دموعي: my tears
دموية: bloody
دمي: my blood
دمية: doll
دمير: demir
دندناقان: dandanjan
دهسنا: we ran over
دواء: medication
دوجان: دوجان
دوجان؟: dogan
دور: role
دورك: your turn
دورنا: our role
دوري: cyclic
دوغان: dogan
دول: countries
دولة: country
دولتنا: our state
دون: without
دوندار: dundar
ديلي: daily
دين: debt
ديني: religious
ديونتي: donte
ديوننا: our debts
ذئب: wolf
ذات: related
ذاهب: going
ذاهبا: he was going
ذاهبون: are going
ذاهبون؟: are they going
ذبح: slaughter
ذبيحة: sacrifice
ذراعينا: our arms
ذراعيها: her arms
ذروة: climax
ذريتك: your offspring
ذريتنا: our offspring
ذريعة: pretext
ذكائك: your intelligence
ذكر: mention
ذكرت: mentioned
ذكرني: remind me
ذكريات: memories
ذكي: intelligent
ذكية: smart
ذلك: that
ذلك؟: that
ذهابهم: they go
ذهابي: my going
ذهب: go
ذهبت: i went
ذهبنا: we went
ذهبوا؟: they went
ذهنك: your mind
ذهنك؟: your mind
ذهني: mental
ذهول: amazement
ذو: thou
ذوق: taste
ذوقك: your taste
ذوقًا: by taste
رآك: see you
رآني: he saw me
رأت: she saw
رأس: head
رأسا: upside down
رأسك: your head
رأسه: his head
رأسها: her head
رأسي: my head
رأى: opinion
رأيت: i have seen
رأيتك: i saw you
رأيته: i saw him
رأيتها: her
رأيتهم: i saw them
رأيك؟: your opinion
رأينا: we saw
رأيي: my opinion
رؤساء: heads
رؤوسنا: our heads
رؤية: vision
رؤيتك: seeing you
رؤيته: see it
رئيس: president
رائحة: smell
رائع: fabulous
رابح: winner
راجعت: i checked
راجل: man
راحة: comfort
راض: satisfied
راضية: satisfied
راضٍ: satisfied
رب: god
ربتها: i raised her
ربحت: i won
ربط: link
ربطه: link it
ربطهم: connect them
ربع: quarter
ربك: your lord
ربما: maybe
ربنا: our lord
ربي: my lord
رتبت: arranged
رجاء: please
رجال: men
رجالك: your men
رجالنا: our men
رجل: a man
رجلا: a man
رجلاً: a man
رجلك: your man
رجلي: my man
رجم: stoned
رجمهم: stoned them
رجموا: they stoned
رجوع: back
رحلة: trip
رحلتك: your journey
رحلتنا: our journey
رحلتهم: their journey
رحمان؟: rahman
رحمة: mercy
رحمك: your uterus
رحمن؟: rehman
رحمه: mercy
رحمها: her womb
رخيصة: cheap
رد: reply
ردود: responses
رسائلها: its messages
رسالة: message
رسالتنا: our mission
رسل: messengers
رسلا: messengers
رسم: draw
رسول: messenger
رشقوا: they threw
رشيقة: agile
رعاة: shepherds
رعاياك: your subjects
رعاية: care
رغب: wish
رغبة: desire
رغبتك: your desire
رغبتكم: your wish
رغبتنا: our wish
رغبته: his wish
رغم: despite
رف: rack
رفاقك؟: your comrades
رفاقي: my comrades
رفاهية: luxury
رفض: refusal
رفضها: rejected
رفضهم: reject them
رفيع: thin
رفيعا: high
رفيقا: buddy
رفيقي: my companion
رفيقًا: companion
رقابنا: our necks
رقبتك: your neck
رقبتها: her neck
رقصها: her dance
رقيب: sergeant
ركبت: ride
ركز: focus
ركض: run
ركن: corner
ركوب: ride
رماد: ash
رمضان: ramadan
رموز: symbols
رمي: throw
رميت: i threw
رهينة: hostage
روحك: your soul
روحه: his soul
روحي: my soul
روحيًا: spiritually
روزالينا: rosalina
روضتها: tame her
روما: rome
زال: removed
زالوا: they removed
زاوية: angle
زراعة: agriculture
زرع: planting
زرعوا: they planted
زعماء: bosses
زفاف: wedding
زفافك: your wedding
زفافنا: our wedding
زلت: i still
زلنا: we are still
زنجيد: zanjid
زنزانات: dungeons
زنزانة: prison cell
زوار: visitors
زوارنا: our visitors
زوج: husband
زوجة: wife
زوجتك: your wife
زوجتي: my wife
زوجك: your husband
زوجها: her husband
زوجي: my husband
زوراء: zora
زيارة: visit
سآتي: i will come
سآخذ: i'll take
سأبقى: i will stay
سأبكي: i'm gonna cry
سأبلغ: i will inform
سأتحدث: i will talk
سأتصل: i'll call
سأجده: i'll find him
سأجعل: i will make
سأجعلهم: i will make them
سأجلب: i will bring
سأجلس: i will sit
سأجيب: i will answer
سأحزبه: i will party him
سأحصل: i will get
سأحضر: i will attend
سأحضرهم: i'll get them
سأخبر: i will tell
سأخبرك: i will tell you
سأخدم: i will serve
سأخصص: i will allocate
سأدمركم: i will destroy you
سأذكرك: i'll remind you
سأذهب: i will go
سأرسل: i will send
سأركب: i will ride
سأزودها: i'll supply it
سأزور: i will visit
سأستعيد: i will regain
سأشتري: i'll buy
سأشتريها: i'll buy it
سأشعر: i will feel
سأصل: i will arrive
سأصلي: i will pray
سأضربك: i'll beat you
سأطعمك: i'll feed you
سأطلب: i will ask
سأظل: i remain
سأعتني: i'll take care
سأعطي: i will give
سأعطيك: i'll give you
سأعود: i'll come back
سأعيد: i will return
سأعيدهم: i'll bring them back
سأفعل: i will
سأفعله: i will do it
سأقاتل: i will fight
سأقترح: suggest
سأقتل: i will kill
سأقتلك: i will kill you
سأقدم: i will make
سأقدمه: i will submit
سأقرر: i will decide
سأقطعه: i'll cut it
سأقول: i will say
سأقولها: i will say it
سأقوم: i will
سأكون: i'll be
سأل: asked
سألت: i asked
سألتني: she asked me
سأنتظر: i'll wait
سأنتقل: i'll move on
سأنتقم: i will take revenge
سأنشره: i will publish it
سأنهي: i will finish
سأهمس: i'll whisper
سأوجه: i will direct
سؤالًا: a question
سئل: he was asked
سئمت: fed up
سئمنا: we are tired
سابق: former
سابين: sabine
ساخن: hot
سارا: sara
ساري: i will see
ساري؟: i will see
ساعدتنا: she helped us
ساعدك: helped you
ساعدني: help me
ساعده: help him
ساعدهم: help them
ساعدوك؟: help
سافعل: i will
ساقه: his leg
سالمة: unscathed
سالمين: unharmed
سامح: sameh
سامحني: forgive me
سامية: sublime
سباقات: racing
سبب: reason
سبحانه: glory be to him
سبع: seven
سبعة: seven
سبق: already
ستأتي: will come
ستأخذني؟: you take me
ستبقى: will remain
ستتحقق: will come true
ستتركنا: will leave us
ستتزوج: she will get married
ستتوقف: will stop
ستجعلني: it will make me
ستحافظ: will maintain
ستحصل: you will get
ستحقق: will achieve
ستخبرني؟: will you tell me
ستختفي: will disappear
ستذهب: you will go
سترونه: you will see it
سترى: you'll see
ستشرق: will rise
ستضع: will put
ستطيعني: you will obey me
ستعمل: will work
ستعيش: you will live
ستغادر؟: are you leaving
ستفعل: you will do
ستفعل؟: you will do
ستقبض: will catch
ستقف: will stand
ستقول: would say
ستقوم: will
ستكون: it will be
ستنتهي؟: will it end
ستنجح: you will succeed
ستهرب: you will run away
ستواجه: will face
ستوب: stop
سجاد: carpets
سجناءك: your prisoners
سجنه: imprisoned
سجين: prisoner
سحابة: cloud
سحابتين: two clouds
سحابتين؟: two clouds
سحابيتين: two clouds
سحب: withdrawal
سحق: crush
سحقت: crushed
سحقك: crush you
سخطهم: their indignation
سخيفا: silly
سخيفة: silly
سداد: pay
سدادة: stopper
سدادها: repaid
سدى: in vain
سر: secret
سرا: secretly
سراح: released
سرادق: marquee
سرادقنا: our marquee
سرادقنا؟: our marquee
سرق: he stole
سرقوا: they stole
سري: secret
سرية: secrecy
سريره: his bed
سريع: fast
سريعا: soon
سريعة: a quick
سريعًا: soon
سعادة: happiness
سعادتنا: our happiness
سعادتها: her happiness
سعادتي: my happiness
سعداء: happy
سعر: price
سعيد: happy
سعيدا: happy
سعيدة: happy
سعيدًا: happy
سفراء: ambassadors
سفك: shed
سفير: ambassador
سفيرًا: as an ambassador
سفينة: a ship
سقط: he fell
سقطت: fell
سقي: quench
سكين: a knife
سلاجقة: seljuks
سلاح: a weapon
سلاحي: my weapon
سلالة: strain
سلام: peace
سلامتك: your safety
سلبا: negatively
سلجوق: selcuk
سلجوقيون: seljuks
سلس: smooth
سلسلة: series
سلطان: sultan
سلطان؟: sultan
سلطاننا: our sultan
سلعهم: their goods
سلكه: walked
سليمان: sulaiman
سم: cm
سمبلتون: simpleton
سمح: allowed
سمحت: allowed
سمحوا: they let
سمع: he heard
سمعت: i heard
سمعت؟: i heard
سمعته: reputation
سمعتها: reputation
سمعنا: we heard
سمعناها: we heard it
سمعها: he heard it
سمعوا: they heard
سمو: highness
سموكم: your highness
سموكم؟: your highness
سمومهم: their toxins
سنبدأ: we'll start
سنة: year
سنتحدث: we will talk
سنترك: we'll leave
سنتركهم: we'll leave them
سنجد: we will find
سنجعلها: we will make it
سنجلس: we'll sit
سنحاول: we will try
سنحرس: we will guard
سنحصل: we will get
سنحل: we will solve
سنخضع: we will undergo
سندفع: we will pay
سنذهب: we'll go
سنرتفع: we will rise
سنرى: we'll see
سنزوجها؟: shall we marry her
سنستسلم: we will surrender
سنستسلم؟: shall we surrender
سنسمح: we will allow
سنصل: we will arrive
سنضع: we will put
سنعتني: i'll take care
سنعرض: we'll show
سنعطي: we will give
سنعمل: we will work
سنعود؟: shall we return
سنغادر: we will leave
سنفعل: we will
سنفعل؟: shall we do
سنقدم: we will give
سنقوم: we will
سنك: your age
سنكتشف: we'll find out
سنكون: we will be
سنلتقي: we will meet
سنلجأ: we will turn
سنمتلك: we will have
سنمر: we will pass
سنموت: we will die
سننطلق: we will go
سنهرب: we will run away
سنوات: years
سنوفر: we will save
سهلا: easy
سهلاً: easy
سهلة: easy
سهم: arrow
سهول: plains
سوءا: worse
سواء: whether
سواء؟: whether
سورة: surah
سوزان: susan
سوف: will
سوق: market
سوى: but
سويًا: together
سيء: bad
سيء؟: bad
سيأتي: will come
سيأخذ: gonna take
سيؤخذ: will be taken
سيئا: bad
سيئة: bad
سيئة؟: bad
سيئًا: bad
سيبدأ: will start
سيبقون: they will stay
سيبقى: will stay
سيبيعوننا: they will sell us
سيتحد: will unite
سيتراجع: will retreat
سيترك: will leave
سيتعلم: will learn
سيتم: will be
سيحتاجك: will need you
سيحدث: will happen
سيحل: will solve
سيخبرنا: will tell us
سيخلفك؟: will he succeed you
سيد: mr
سيدتي: madam
سيدك: your master
سيدنا: our master
سيدها: her master
سيدي: sir
سيدي؟: sir
سيذهب: will go
سير: walk
سيرسلني: will send me
سيرون: they will see
سيريحنا: he will comfort us
سيزور: will visit
سيستغرق: would take
سيسعى: will seek
سيسفك: will be shed
سيسلمون: they will deliver
سيسمح: will allow
سيشتعل: will ignite
سيشعر: will feel
سيصبح: gonna be
سيصل: will arrive
سيصيح: will shout
سيطلب: will ask
سيطير: will fly
سيعارض: would oppose
سيعتمد: will depend
سيعطي: will give
سيعطينا: will give us
سيعود: will return
سيعودان: they will come back
سيعيده: he will return it
سيف: sword
سيفتح: will open
سيفخر: will be proud
سيفعل: he will
سيفعلون: they will
سيفك: your sword
سيفه: his sword
سيفوز: will win
سيفي: cv
سيقبل: will accept
سيقتل: will be killed
سيقتله: he will kill him
سيقتلونني: they will kill me
سيقدمون: they will give
سيقول: would say
سيقيم: will reside
سيكامور: sycamore
سيكون: will be
سيكونون: they will be
سيلكان: silcan
سيموت: will die
سيموتون: they will die
سيموتون؟: will they die
سينتهي: will end
سينضم: will join
سينضمون: they will join
سينظر: will look
سيهربون: they will run away
سيواجه: will face
سيوف: swords
سيوفر: will save
سيوفنا: our swords
شأنه: would
شأنها: like it
شئ: a thing
شاء: willing
شائعة: rumor
شاب: young man
شاذة: atypical
شارع: street
شاركتها: share it
شاعراً: poet
شاق: hard
شاكرا: thankful
شاه: shah
شاه؟: shah
شاهد: see
شاهدت: watched
شاهدنا: we watched
شاهدي: watch
شاهزاد: shahzad
شاهزاد؟: shahzad
شاهزاداس: shahzadas
شاهزاده: shahzadeh
شاهزادي: shahzadi
شاهزادي؟: shahzadi
شاهزاديس: shahzadis
شباب: youth
شجاع: brave
شجاع؟: brave
شجاعا: brave
شجاعتك: your courage
شجاعًا: brave
شجرة: tree
شخص: person
شخصا: people
شخصيا: personally
شخصياً: personally
شخصًا: person
شديد: intense
شر: evil
شراء: purchase
شراؤها: purchased
شرب: drink
شربات: sherbet
شربت: i drank
شرط: condition
شرعت: embarked
شرف: honor
شرفتنا: our balcony
شرفك: your honor
شرفنا: our honor
شركاء: partners
شركته: his company
شروق: rise
شريرة: wicked
شريف: sherif
شعب: people
شعبنا: our people
شعبه: section
شعر: poetry
شعرت: i felt
شعرك: your hair
شعرنا: we felt
شعرها: her hair
شعروا: they felt
شعوب: people
شعور: feeling
شفا: verge
شفتك: i saw you
شفتي: my lips
شفق: twilight
شفقة: compassion
شفى: he healed
شفي: cured
شقراء: blonde
شقيق: brother
شقيق؟: brother
شقيقها: her brother
شقيقي: my brother
شقيًا: naughty
شكرا: thanks
شكراً: thanks
شكوك: doubts
شم: sniff
شمعة: a candle
شممت: smelled
شنق: hang up
شهداء: martyrs
شهرتك: your fame
شهزاد: shehzad
شهزاد؟: shehzad
شهزادز: shehzadz
شهزادس: shehzads
شهزاديس: shehzadis
شهود: witnesses
شهور: months
شهيد: martyr
شهير: famed
شوارع: streets
شي: shi
شيء: thing
شيء،: thing,
شيء؟: thing
شيئ: thing
شيئا: nothing
شيئًا: something
شيخ: sheikh
شيخنا: our sheikh
شيك: check
شِئًا: nothing
صاحب: owner
صاحبه: its owner
صادقين: are honest
صالح: valid
صالحنا: our advantage
صامت: silent
صامتة: silent
صانع: maker
صباح: morning
صبر: patience
صبور: patient
صبورا: be patient
صبي: boy
صح: true
صحة: health
صحتها: her health
صحية: healthy
صحيح: true
صحيح؟: true
صحيحا: right
صحيحة: correct
صحيحًا: right
صخرة: a rock
صخور: rocks
صد: bodice
صدر: released
صدقه: charity
صدقوني: believe me
صدنا: we repelled
صدورهم: chests
صديق: friend
صديقك: your friend
صديقي: my friend
صديقًا: a friend
صراخ: screaming
صراعا: tangling
صربية: serbian
صرت: i became
صرخ: shouted
صرخات: screams
صرخاتهم: their cries
صعب: difficult
صعب؟: difficult
صعبا: difficult
صعبة: difficult
صعبًا: difficult
صعدنا: we went up
صعوبات: difficulties
صعوبة: difficulty
صغير: small
صغيرة: small
صفقة: deal
صفيحة: plate
صلاة: prayer
صلاتي: my prayer
صلاح: salah
صلواتي: my prayers
صليبي: crusader
صليبية: crusade
صماء: deafness
صندوق: box
صنع: make
صنعا: do well
صنعت: manufactured
صنعتها: i made it
صوت: voice
صوتك: your voice
صوتي: my voice
صياد: fisher man
صيحات: shouts
ضائع: lost
ضائقة: hardship
ضابط: officer
ضابطا: an officer
ضابطاً: an officer
ضارة: harmful
ضاع: lost
ضبابي: hazy
ضبط: adjust
ضجة: sensation
ضحك: laughter
ضحية: victim
ضحيتك: your victim
ضد: against
ضدك: against you
ضدنا: against us
ضده: against him
ضدي: against me
ضرائبها: their taxes
ضرائبها؟: their taxes
ضرائبهم: their taxes
ضرائبهم؟: their taxes
ضربة: a hit
ضربه: a hit
ضرر: harm
ضع: put
ضعف: weakness
ضعفي: my weakness
ضعفًا: weakness
ضعه: put it
ضعها: put it
ضعي: apply
ضعيف: weak
ضفاف: banks
ضوء: light
ضيف: guest
ضيف؟: guest
ضيفك: your guest
ضيفنا: our guest
ضيفنا؟: our guest
ضيفي: my guest
ضيوف: guests
ضيوفنا: our guests
ضيوفنا؟: our guests
ضيوفه: his guests
طائر: a bird
طائشة: stray
طائفتنا: our community
طارئة: emergency
طاعون: plague
طاعون؟: plague
طاغية: tyrant
طاقتي: my energy
طال: long
طالب: student
طالما: as long
طاولة: table
طبعا: of course
طبيب: doctor
طرح: subtract
طرحت: posed
طرد: kick
طريح: outright
طريق: way
طريقة: method
طريقتك: your style
طريقك&quot;: your way &quot;
طريقك: your way
طريقنا: our way
طريقه: method
طريقها: its way
طريقي: my way
طعام: food
طعامهم: their food
طعم: taste
طعن: stab
طغت: overwhelmed
طفل: child
طفلك: your child
طفلنا: our child
طفلها: her child
طفلي: my baby
طلب: order
طلبت: requested
طلبتم،: you asked,
طلبتها: i asked
طلبك: your request
طلبنا: we asked
طلبه: his request
طلبهم: their request
طموح: ambition
طوال: throughout
طول: length
طويل: long
طويلا: long
طويلة: long
طويلة؟: long
طيب: ok
طيبة: kind
طيرني: fly me
ظل: shade
ظلما: unjustly
ظهرت: appeared
ظهرك: your back
ظهري: my back
ظهورنا: our backs
عائلات: families
عائلة: a family
عائلتك: your family
عائلتنا: our family
عائلتي: my family
عاجلا: sooner
عاجلاً: sooner
عاد: is back
عادات: habits
عاداتك: your habits
عاداتك؟: your habits
عاداتنا: our habits
عاداته: his habits
عاداتهم: their habits
عادتنا: our custom
عادل: fair
عادلاً: fair
عادلة: fair
عادوا: they returned
عادي: normal
عار: shame
عار؟: shame
عارية: naked
عازم: determined
عازمون: are bent
عاصفة: storm
عاصي: assi
عالق: stuck
عالقون: are stuck
عالم: world
عالمي: my world
عاليا: high above
عالية؟: high
عام: public
عامة: general
عامل: worker
عاملهم: their worker
عاملوك: they treated you
عامًا: years
عانتنا: we suffered
عانى: suffer
عانيت: i suffered
عبئا: a burden
عباءة: cloak
عبادة: worship
عباسي: abbasi
عبثا: in vain
عبد: slave
عبدا: a slave
عبدي: my servant
عبرك: across you
عبلة: abla
عبلة؟: abla
عبوس: frown
عبيدهم: their servants
عجائب: wonders
عجل؟: hurry
عجلوا: hurry up
عجوز: old
عجين: dough
عد: counting
عداد: counter
عدالة: justice
عدالة؟: justice
عدة: several
عدت: i returned
عدد: number
عدلك: your justice
عدم: non
عدنا: we are back
عدو: enemy
عدو؟: enemy
عدوك: your enemy
عذابنا: our torment
عذرا: excuse me
عربي: arabic
عربي؟: arabic
عرش: throne
عرشه: his throne
عرضت: offered
عرضتم: you offered
عرضي: accidental
عرفت: i knew
عروس: bride
عروسنا: our bride
عروسه: bride
عزاءنا: our consolation
عزالدين: izz aldin
عزام: عزام free membership
عزرائيل: angel of death
عزيز: aziz
عزيزتي: darling
عزيزى: my dear
عزيزي: my dear
عسى: hopefully
عشائر: clans
عشائرتي: my clan
عشاقنا: our lovers
عشت: i lived
عشرات: tens
عشيرة: clan
عشيرتك: your clan
عشيرتنا: our clan
عصبي: neural
عصرنا: our time
عصفورين: two birds
عصيان: disobedience
عصيت: i disobeyed
عضو: member
عضوا: member
عفسين: afsin
عقب: after
عقبة: obstacle
عقد: a necklace
عقلك: your mind
عقلك؟: your mind
عقله: his mind
عقلها: her mind
عقلي: my mind
عقوبته: his punishment
عقولنا؟: our minds
عكيز؟: okay
علاء: علاء
علاج: treatment
علاجا: cure
علاجها: treated
علاجًا: treatment
علاقتنا؟: our relationship
علامة: sign
علاوة: bonus
علقت: hung up
علم: knowledge
علم؟: knowledge
علمت: i learned
علمنا: taught us
على: on
علي: ali
عليك: on you
عليكم: on you
عليكما: you both
علينا: we
عليه: on him
عليه؟: on him
عليها: on her
عليهم: on them
عليّ: ali
عم: uncle
عم؟: uncle
عما: from
عمال: workers
عمدة: mayor
عمر: omar
عمك: your uncle
عمل: action
عملت: i worked
عملك: your business
عملنا: our work
عملهم: their work
عملية: operation
عمنا: our uncle
عمنا؟: our uncle
عمه: aunt
عمه؟: aunt
عمها: her uncle
عمود: pole
عمي: my uncle
عمي؟: my uncle
عميق: deep
عميقة: deep
عمّنا: our uncle
عن: about
عن؟: about
عنا: about us
عنا؟: about us
عناء: trouble
عناد: intransigence
عند: at
عندما: when
عندنا: we have
عندها: then
عنقه: his neck
عنك: about you
عنك؟: about you
عنه: about him
عنه؟: about him
عنها: about her
عنهم: about them
عني: about me
عني؟: about me
عنيدة: stubborn
عنيدًا: stubborn
عنيدًا؟: stubborn
عهد: covenant
عواقب: consequences
عودة: back
عودتك: your return
عودته: his return
عودتهم: they return
عيسى: jesus
عيسى؟: jesus
عيكيز: ekeiz
عيكيز؟: okay
عين: eye
عيناه: his eyes
عيناي: my eyes
عينني: eye me
عيني: eyes
عينيك: your eyes
عينيه: his eyes
عيون: eyes
غادر: leave
غادرت: she left
غادرنا: we left
غادروا: they left
غارة: raid
غازانفار: gazanfar
غازنفار: gazanfar
غازنفر: gaznver
غاضب: angry
غاضبًا: angry
غاليا: dearly
غامرة: immersive
غبية: stupid
غد: tomorrow
غدا: tomorrow
غداً: tomorrow
غدًا: tomorrow
غرب: west
غرفة: room
غرفتك: your room
غرفتها: her room
غرفك: your rooms
غروبها: sunset
غريب: a stranger
غريبًا: weird
غريرا: guerrilla
غزانفر: ghazanfar
غزانفر؟: ghazanfar
غزنفر: ghazanfar
غزو: invade
غزوة: foray
غسلها: washed
غصين: twig
غض: juicy
غضب: anger
غضبه: his anger
غضبهم: their anger
غضنفر: ghazanfar
غضون: meantime
غطاء: cover
غطرسته: his arrogance
غفر: forgive
غندوغدو: gondogdo
غودسند: godsend
غوندوغدو: gundogdu
غير: non
غيره: jealous
فأخبرنا: so tell us
فأخبره: so tell him
فأود: i would
فإن: the
فإنك: then you
فإنه: it
فإنهم: they will
فائدة: benefit
فات: rolls
فاذهب: so go
فارس: knight
فارغا: empty
فارغة: empty
فارغًا: empty
فاستفسرت: i inquired
فاعرف: know
فالقبيلة: the tribe
فالناس: people
فتاة: girl
فتاتي: my girl
فتاتي؟: my girl
فتحت: i opened
فترة: interval
فتى: boy
فجأة: suddenly
فحصنا: we checked
فحصه: check it out
فحصها: checked
فخ: trap
فخر: pride
فخرك: your pride
فخوراً: proud
فخًا: a trap
فداء: fida
فراش: mattress
فرس: mare
فرسان: knights
فرسانك: your knights
فرسانهم: their knights
فرصة: chance
فرضنا: we imposed
فرع: a branch
فريقنا: our team
فزت: i won
فسأجعلك: i will make you
فسأنتقم: i will avenge
فستصبح: it will become
فستكون: it will be
فسنحصل: we will get
فسنحكم: we will judge
فسوف: you'll
فشل: fail
فشلت: failed
فشلك: your failure
فصاعدا: onwards
فصاعدًا: onwards
فصل: season
فضفاضة: loose
فضلك: please
فضيلة: virtue
فعالة: effective
فعالية: effectiveness
فعل: act
فعل؟: act
فعلا: really
فعلت: i did
فعلت؟: i did
فعلته: i did
فعلنا: we did
فعلنا؟: we did
فعله: he did
فعله؟: done
فعلها: do it
فعلوا: they did
فعلوه: they did
فعليه: he should
فقد: lost
فقدان: loss
فقدت: lost
فقدت؟: lost
فقدنا: we lost
فقدناه: we lost it
فقدناها: we lost it
فقده: lost
فقدوا: they lost
فقط: just
فقير: poor
فقيرة: poor
فقيه: jurist
فك: unpack
فكر: thought
فكرة: idea
فكرت: i thought
فكه: humorous
فكيف: so how
فلا: not
فلن: you won't
فليكن: let it be
فليكنوا: let them be
فليمنحهم: give them
فم: mouth
فماذا: so what
فمك: your mouth
فمن: it is
فمه: his mouth
فهل: so does
فهم: understanding
فهمت: i see
فهمك: your understanding
فهو: it is
فهي: they are
فوجئت: i was surprised
فوز: win over
فوضى: mess
فوق: above
فوقنا: above us
في: in
في؟: at
فيقول: he says
فيك: in you
فيكم: in you
فيلم: movie
فيما: with respect
فيمكننا: we can
فينا: vienna
فينيسيا: venice
فيه: in it
فيها: in which
فيها؟: in which
فيهم: including
قائد: leader
قائد؟: leader
قائدا: commander
قائدنا: our leader
قائدهم: their leader
قائدهم؟: their leader
قائلا: saying
قائمة: list
قائمة؟: list
قاب: just around
قابلة: met him
قابلنا: we met
قاتل: killer
قاتلت: she fought
قاتلنا: we fought
قاد: drove
قادة: leaders
قادرة: able
قادرين: able
قادرًا: able
قادم: coming
قادمة: coming
قادمون: coming
قاراتويغار: karatwegar
قافلة: convoy
قافلتك: your caravan
قال: he said
قال؟: he said
قالت: she said
قالوا: they said
قام: he rose
قانونية: legal
قايي: kay
قبائلنا: our tribes
قبالة: off
قبح: ugliness
قبر: grave
قبراً: graves
قبره: lark
قبض: catch
قبضة: grip
قبضت: i got
قبعة: hat
قبل: before
قبلت: accepted
قبلي: tribal
قبور: graves
قبول: acceptance
قبيلة: tribe
قبيلة؟: tribe
قبيلتك: your tribe
قبيلتنا: our tribe
قبيلتنا؟: our tribe
قبيلته: his tribe
قبيلتي: my tribe
قتال: fighting
قتل: killing
قتلة: killers
قتلت: she was killed
قتلته: i killed him
قتلته؟: you killed him
قتلك: kill you
قتلكم: kill you
قتلنا: kill us
قتله: killers
قتله؟: killers
قتلها: killed her
قتلهم: kill them
قتلوا: were killed
قتلي: kill me
قد: may be
قداسة: holiness
قدامى: veterans
قدر: saucepan
قدرة: capacity
قدري: my destiny
قدما: ahead
قدمت: submitted
قدمتموه: you have given
قدمنا: we introduced
قدمه: his foot
قدمها: give it
قدموه: they gave it
قدموها: give it
قدمي: my foot
قدميك: your feet
قدمًا: ahead
قدوة: example
قديم: old
قديمون: are old
قديمًا: old
قذر: dirty
قرأت: i read
قراءة: reading
قراتويغار؟: karatwigar
قرار: resolution
قرارات: resolutions
قرارك: your decision
قراره: his decision
قراري؟: my decision
قرب: near
قرباني: sacrificial
قرر: he decided
قررت: i decided
قررنا: we decided
قريب: near
قريب؟: near
قريبا: soon
قريباً: soon
قريبة: close
قريبًا: soon
قسم: department
قصة: a story
قصدك: you mean
قصر: palace
قصرك: your palace
قصرنا: our palace
قصره: his palace
قصك: your story
قصور: failure
قضايا: issues
قضية: issue
قضيتك: your case
قضيتنا: our cause
قضيتهم: their cause
قضيناها: we spent it
قط: never
قطاع: section
قطرة: drop
قطع: cut
قطعان: flocks
قطعاننا: our flocks
قطعة: plot
قطعوا: they cut
قف: stop
قل: say
قلادة: necklace
قلب: heart
قلبك: your heart
قلبك؟: your heart
قلبه: his heart
قلبها: her heart
قلبي: my heart
قلبي؟: my heart
قلت: i said
قلته: you said
قلتها: i said it
قلعة: castle
قلق: anxiety
قلقا: worried
قلقة: worried
قلقك: your concern
قلقون: are worried
قلقين: worried
قلها: say it
قلوب: hearts
قلوبكم: your hearts
قلوبنا: our hearts
قليل: little
قليلا: a little
قليلا،: a little,
قليلا؟: a little
قليلاً: a little
قليلة: few
قم: get up
قمة: summit
قمت: you've
قمنا: we've
قوة: energy
قوتك: your strength
قوتهم: their strength
قوسين: parentheses
قول: say
قوله: saying
قولي: say
قونيا: konya
قونية: konya
قوي: strong
قويا: strong
قوياً: strong
قوية: powerful
قيادة: leadership
قيادتكم: your leadership
قيادتنا: our leadership
قيامة: resurrection
قيد: restriction
قيس: measure
قيلت: it was said
قيم: values
قيمة: values
قيمتها: worth
قَدَّمَ: foot
قُتلوا: were killed
كأب: cap
كأنني: like i am
كإجراء: as a measure
كابوس: nightmare
كاتب: clerk
كاذب: untruthful
كارا: kara
كاراتويغار: karatwigar
كاراديري: karadiri
كارافانساري: caravansary
كارتال: kartal
كارثة: disaster
كاسم: as the name
كاف: adequate
كافر: infidel
كافي: enough
كافيا: enough
كافياً: enough
كافية: enough
كافيًا: enough
كالعادة: as usual
كالمقلق: like worrying
كامرأة: as a woman
كامرأة؟: as a woman
كامل: whole
كاملة: perfect
كان: it was
كان؟: it was
كانت: was
كانوا: they were
كاي: kay
كاي؟: kay
كايس: case
كايس؟: kayes
كايي: kaye
كاييس: kayes
كبار: senior
كبر: grow up
كبرياءك: your pride
كبريائك: your pride
كبش: ram
كبير: large
كبيرا: great
كبيرة: big
كبيرًا: great
كتاب: book
كتب: wrote
كتبت: i wrote
كتبه: written by
كتبه؟: written by
كتفيك: your shoulders
كتلة: mass
كتم: mute
كثب: closely
كثير: a lot
كثيرا: much
كثيرا؟: much
كثيراً: much
كخائن: as a traitor
كدروع: as shields
كدنا: ckdna
كدي: skewer
كذابون: liars
كذبة: a lie
كذبت: she lied
كذلك: as well
كذلك؟: as well
كرة: a ball
كرجل: as a man
كرسول: as a messenger
كرمتنا: our generosity
كرمتني: she honored me
كرهينة: as a hostage
كريمة: decent
كسجناء: as prisoners
كسجين: as a prisoner
كسجين؟: as a prisoner
كسر: broke down
كسرت: broken
كسرنا: we broke
كسول: lazy
كشركة: as a company
كشك: booth
كشكًا: stall
كطفل: as a child
كعروس: as a bride
كفء: efficient
كفاءة: efficiency
كفريق: as a team
كفنه: shroud
كفى: is enough
كقبضة: as a fist
كقبيلة: as a tribe
كل: all
كلا: both
كلاب: dog
كلابك: your dogs
كلاكما: both of you
كلام: talking
كلامي: my words
كلانا: both of us
كلاهما: both of them
كلب: dog
كلل: unfailing
كلمات: lyrics
كلماتك: your words
كلماتنا: our words
كلماتها: her words
كلماتي: my words
كلمة: a word
كلمتها: her word
كلنا: all of us
كله: entire
كله؟: entire
كلها: all of which
كلهم: all of them
كم: how many
كما: as such
كمبعوث: as an envoy
كملكة: as a queen
كممثل: as an actor
كمين: trap
كمينا: ambushed
كمينًا: ambushed
كن: be
كنا: we were
كنت: you
كنت؟: i was
كنز: treasure
كهدية: as a gift
كورد: cord
كوردوغلو: kordoglu
كوردوغلو؟: kordoglu
كومة: pile
كونه: being
كوني: connie
كيس: bag
كيف: how do
كيف؟: how do
كيفية: how to
كيقباد: kiqbad
كيليكارسلان: kilicarslan
كيوكباد: qukpad
ل: to
ل؟: to
لآلئ: pearls
لأبي: for dad
لأبيك: to your father
لأبيه: to his father
لأجعلك: to make you
لأجلي: for me
لأحبائنا: for our loved ones
لأحد: for one
لأخبرك: to tell you
لأختك: for your sister
لأختي: for my sister
لأخذه: to take it
لأخذها: to take it
لأخذهم: to take them
لأخي: for my brother
لأخي؟: for my brother
لأخيك: for your brother
لأداء: to perform
لأرواح: for spirits
لأصدقائك: to your friends
لأصدقائنا: to our friends
لأطفالي: for my children
لأطلب: to order
لأقول: to say
لأقوله: to say
لأكاكوكا: for akakuka
لأكله: to eat it
لأمك: for your mother
لأن: because
لأناقشها: to discuss it
لأنفسكم؟: for yourselves
لأنك: because you are
لأننا: because we are
لأنني: because i
لأنه: because he
لأنها: because she
لأنهم: because they are
لأني: because i am
لأهدافك؟: for your goals
لأول: for the first
لأولئك: for those
لأي: for any
لؤلؤة: pearl
لإبقاء: to keep
لإبلاغ: to inform
لإبلاغنا: to inform us
لإخراجه: to take him out
لإخفائه: to hide it
لإدانته: to convict him
لإرضاء: to please
لإزعاج: to inconvenience
لإضعاف: to weaken
لإعادة: to recreate
لإعداد: to prepare
لإعطاء: to give
لإقامة: to set up
لإقناع: to impress
لإقناعه: to convince him
لإلقاء: to shed
لإنفاق: to spend
لإنقاذ: to save
لإنقاذك: to save you
لإنهاء: to finish
لإيجاد: to find
لإيقاظ: to wake up
لا: no
لا؟: no
لائق: decent
لابد: it must
لابن: to a son
لابنك: for your son
لابني: for my son
لاتخاذ: to take
لاحق: later
لاحقا: later
لاحقًا: later
لاحقًا؟: later
لاستجوابي: for questioning me
لاستضافتك: for your hosting
لاستفزاز: to provoke
لاقامة: to set up
لامر: to the order
لاين: line
لبس: wear
لبعض: for some
لبقاء: to stay
لبك: to your
لبلدي: for my country
لبي: pulpy
لبيع: to sell
لتأخذها: to take them
لتبحث: for looking
لتحذيراتي: to my warnings
لتحرير: to edit
لتحطيمه: to smash it
لتحقيق: to achieve
لتحية: to greet
لتري: to see
لتزوج: to get married
لتزويد: to supply
لتزويده: to supply it
لتزويدهم: to provide them
لتسمم: to poison
لتصبح: to become
لتظهر: to appear
لتعبئة: to mobilize
لتفسير: to interpret
لتفعله: to do
لتقول: to say
لتقوله: to say
لتقولها: to say
لتكون: to be
لتلك: to those
لتلوث: to contaminate
لتمجيد: to glorify
لتناول: to take up
لتهدئتهم: to calm them down
لتهنئتك: to congratulate you
لتوديعه: to say goodbye
لتورجوت: for turgut
لتولي: to take over
لتيتوس: to titus
لثانية: for a second
لجأت: resorted
لجأنا: we took refuge
لجأوا: they took refuge
لجدول: for a table
لجلب: to bring
لجمع: to collect
لجميع: for all
لجناح: for the suite
لحاكم: to the governor
لحجر: for a stone
لحساب: to calculate
لحسن: for good
لحضور: to attend
لحظات: moments
لحظة: moment
لحفظ: to save
لحفيده: to his grandson
لحل: to solve
لحماية: to protect
لحملة: to drive
لحياتي: for my life
لحية: beard
لحيتك: your beard
لحيته: his beard
لحيتي: my beard
لخداع: to fool
لخسائرنا: for our losses
لخسارتك: for your loss
لخطفنا: to kidnap us
لخلق: to create
لخيمة: for a tent
لدرء: to ward off
لدرجة: so so
لدغات: bites
لدى: i have
لدي: i have
لديك: you have
لدينا: we've got
لدينا؟: we've got
لديه: he have
لديها: she has
لديهم: they have
لديّ: i have
لذا: so
لذلك: so
لرؤية: to see
لرؤيتك: to see you
لرؤيته: to see him
لربط: to relate
لرحلة: for a trip
لرحلتك: for your trip
لرسولنا: to our messenger
لرعي: to graze
لرغبات: to the wishes
لرفضه: to reject it
لرمي: to throw
لزم: necessary
لزوجتك: for your wife
لزوجها: to her husband
لزيارتك: for your visit
لزيارتنا: to visit us
لسانك: your tongue
لسانه: his tongue
لساني: my tongue
لسبب: for a reason
لسبتي: for sabbatati
لست: i'm not
لسحابتين: for two zippers
لسحق: to crush
لسلامة: for safety
لسليمان: to solomon
لسماع: to hear
لسماعه: to hear it
لسنا: we are not
لسنوات: for years
لسنوات؟: for years
لسوء: for bad
لسيوف: for swords
لشخص: for a person
لشرف: for honor
لشعبنا: for our people
لشفائي: for my recovery
لشفقتك: to your pity
لصاحب: to the owner
لصاحبها: to its owner
لصالح: favor
لصديق: to a friend
لصيد: to catch
لضبط: to adjust
لضيوفنا: to our guests
لضيوفه: to his guests
لطفك: your kindness
لطفًا: kindly
لطيفة: latifa
لعاداتنا: to our habits
لعاداته: for his habits
لعالم: to a world
لعبة: toy
لعبت: i played
لعبك: your play
لعبنا: we play
لعدة: for several
لعزيز: to aziz
لعقد: to hold
لعقل: to mind
لعلاجي: for my treatment
لعن: curse
لعنة: a curse
لعنتهم: their curse
لـ: for
لفترة: for a while
لفعل: to do
لفعله؟: to do
لفوج: for vogue
لقاء: meeting
لقب: title
لقبيلة: to the tribe
لقتل: to kill
لقتلك: to kill you
لقتله: to kill him
لقتله؟: to kill him
لقتلهم: to kill them
لقد: lhave
لقضاء: to spend
لقطعانك؟: for your flocks
لقلبك: for your heart
لقلبه: for his heart
لك: is yours
لك؟: is yours
لكارا: for kara
لكاراتويغار: for karatwigar
لكاراتويغار؟: for karatwigar
لكان: for was
لكايس: for kayes
لكتيبة: for a battalion
لكسر: to break
لكل: for every
لكم: to you
لكمة: punch
لكمين: to ambush
لكن: but
لكن،: but,
لكنا: but the
لكنك: but you are
لكننا: but we are
لكنني: but i do
لكنه: but he
لكنها: but she
لكنهم: but they
لكني: but i do
لكورد: for cord
لكونه: for being
لكي: in order to
لل: of
للآخرين: to others
للأتراك: for the turks
للأجداد: for grandparents
للأساليب: for methods
للأسفل: down
للأشخاص: for people
للأكل: to eat
للأم: to the mother
للأمراء: for princes
للأيام: for days
للإعجاب: impressive
للإهانة: to insult
للاحتفاظ: to retain
للاختباء؟: to hide
للاستسلام: to surrender
للاستعداد: to prepare
للاستقالة: to resign
للاله: for god
للانتفاضة: of the uprising
للانتقام: for revenge
للانضمام: to join
للبابا: for the pope
للبحث: search
للبقاء: to stay
للبكاء: to cry
للبيع: for sale
للتأثير: to influence
للتجول: to roam
للتحدث: to talk
للتحقق: to check
للترفيه: for entertainment
للتزويد: to replenish
للتضحية: to sacrifice
للتعامل: to deal
للتعاون: to cooperate
للتعبئة: for packing
للتعلم: to learn
للتغلب: to overcome
للتفكير: to think
للتو: just yet
للثروات: for riches
للجمارك: for customs
للجميع: for everyone
للجوء: for asylum
للجيش: for the army
للحاكمين: for the rulers
للحديث: to talk
للحروب: for wars
للحساب: for the account
للحصول: to get
للحضور: to come
للحظة: for a bit
للحفاظ: to maintain
للحيل: for tricks
للحيوانات: for animals
للخروج: to get out
للخروج؟: to get out
للخطر: to risk
للخلاص: for salvation
للخلافة: to succeed
للخوف: to fear
للخيل؟: for horses
للدخول: to enter
للدموع: for tears
للذهاب: to go
للذهاب؟: to go
للرجال: for men
للرحلة: for the trip
للرحلة؟: for the trip
للرسالة: for the message
للرسل: for the apostles
للرعي؟: for grazing
للسلطان: to the sultan
للسماح: to allow
للسيطرة: to control
للشباب: for young people
للصيد: for hunting
للضرب: beaten
للضرر: for damage
للطاغية: for the tyrant
للطاغية؟: for the tyrant
للطريق: for the road
للطغاة: to tyrants
للطفل: for the child
للعار: to shame
للعالم: for the world
للعب: to play
للعثور: to find
للعدالة: to justice
للعدو: to the enemy
للعمل: for work
للعودة: to return
للعيش: for living
للعين: to the eye
للعيون: for the eyes
للغارة: for the raid
للغاية: extremely
للغزال: for deer
للغضب: to anger
للفتاة: for the girl
للفرسان: for the knights
للفوج: for the regiment
للفوز: to win
للقاء: to meet
للقافلة: for the convoy
للقبض: to catch
للقبيلة: for the tribe
للقتال: to fight
للقتل: to kill
للقلق: to worry
للقلق؟: to worry
للقيام: to do
للكسر: to break
للكلاب: for dogs
للكمين: for the ambush
للمحتاجين: for the needy
للمرضى: for patients
للمعلومات: for information
للمغادرة: to leave
للمنزل: for home
للموت: to die
للناس: to people
للنجوم: for the stars
للنظر: to look
للنوم: to sleep
لله: allah
للهجرة: to migrate
للهجوم: to attack
للهجوم؟: to attack
للوزير: for the minister
للوصول: to reach
للوقوف: to stand up
لم: did not
لماذا: why
لماذا؟: why
لمثل: to like
لمجرد: just because
لمحاكمة: to try
لمحبة: for love
لمدة: for two
لمرة: for once
لمرضه: for his illness
لمساعدتك: to help you
لمساعدتكم: for your help
لمستقبل: for the future
لمستقبلك: for your future
لمشاهدة: to watch
لمشكلتك: for your problem
لمعتقداتهم: to their beliefs
لمعرفة: to find out
لمغادرة: to leave
لمقر: to headquarters
لممارسة: to practice
لمن: whose
لمهاجمة: to attack
لمهاجمتهم: to attack them
لموت: to die
لن: will not
لنا: our
لنتحدث: let's talk
لنرى: let's see
لنرى؟: to see
لنشر: to spread
لنظام: for the system
لنعرف: to know
لنعود: to come back
لنفسك: for yourself
لنفسي: for myself
لنقوم: let's
لنكون: to be
له: for him
لهؤلاء: for those
لها: to her
لهذا: for this
لهذا؟: for this
لهذه: for these
لهم: for them
لهم؟: for them
لهما: for them
لو: lou
لواء: major general
لوالدي: to my father
لوجه: to face
لوحدة: for the unit
لوحدك: on your own
لودج: lodge
لوزيرنا: to our minister
لوصف: to describe
لوضع: to put
لوقت: for a time
لولا: for it not
لي: mine
لي،: mine,
لي؟: mine
ليأتي: to come
لياقة: fitness
ليباركك: bless you
ليجت: legit
ليدها: to her hand
ليس: not
ليست: not
ليسوا: they are not
ليصبح: to become
ليصبحوا: to become
ليغلق: to close
ليفحص: to be checked
ليقتل: to kill
ليقول: to say
ليكن: let it be
ليكون: to be
ليكونوا: to be
ليلا: night
ليلة: a night
ليلتك: your night
ليلتنا: our night
ليلتي: my night
ليلى: layla
ليلى؟: layla
لينة: soft
ليوفر: to save
ليوم: for a day
مألوفا: familiar
مألوفة: familiar
مأهولة؟: manned
مؤقت: temporary
مؤقتة: temporary
مؤلم: painful
مئات: favorable
ما: what
ما؟: what
ماء: water
ماالذي: what
مات: die
ماتت: she died
ماتوا: they died
ماذا: what
ماذا؟: what
مارسيليا: marseille
ماركوس: marcus
ماركوس؟: marcus
ماريو: mario
مازلت: i'm still
ماسة: desperately
ماشيتهم: their cattle
مافريك: maverick
مالك: owner
مالكهم: their owner
مانح: grantor
مانزيكرت: manzikert
مانع: mind
ماهراً: skillful
ماهو: what is the
ماونتنز: mountains
ماونتين: mountain
مايرام: okay
مايو: may
مبارك: blessing
مباشر: direct
مباشرة: directly
مبالين: indifferent
مبعوث: envoy
مبكر: early
مبكرة: early
متأخر: late
متأخرا: trailed
متأخرة: late
متأخرة؟: late
متأخرين: late
متأكد: certain
متأكدا: sure
متأكدًا: sure
متابعتها: follow them
متاح: available
متاحًا: available
متبقية: remaining
متجر: a store
متجهون: vectors
متحالفًا: allied
متحدا: united
متداولًا: traded
متروك: is up
متسرع: hasty
متعب: tired
متعبا: tired
متعبة: tiring
متعجرفًا: arrogant
متعلمة: educated
متلهفين: eager
متماثلون: are similar
متناول: reach
متوجه: heading
متوفراً: available
متى: when
متى؟: when
متي؟: when
مثل: like
مثلك: same to you
مثلما: as
مثلنا: like us
مثله: like him
مثلي: like me
مثير: thrilling
مثيل: instance
مجرد: just
مجففة: dried
مجموعات: groups
مجموعة: collection
مجنون: crazy
مجنونة: crazy
مجهول: unknown
مجهولي: unknown
محاباة؟: favor
محادثات: talks
محادثة: conversation
محارب: warrior
محاربي: warriors
محاربين: warriors
محاربيه: his warriors
محاربًا: a warrior
محاسبتك: you are charged
محاصر: trapped
محاط: surrounded
محاكمة: trial
محاولة: attempt
محبة: love
محبوب: lovable
محترمة: a respectable
محشوة: stuffed
محظوظ: lucky
محظوظون: are fortunate
محق: right
محكمة: court
محكوم: doomed
محمد: mohammed
محنة: distress
محوها: erase it
محي: wiped
مخاطر: risks
مختلف: different
مختلفا: different
مختلفة: different
مختوم: stamped
مختومة: stamped
مخز: shameful
مخزوننا: our stock
مخطئ: wrong
مخلص: sincerely
مخلصًا: sincerely
مخول: authorized
مدرسة: school
مدرك: aware
مدركين: are aware
مدنك: your cities
مدونة: blog
مدى: bezel
مدين: debtor
مدينة: town
مدينتي: my city
مدينون: owe it
مر: pass
مرات: times
مرارا: repeatedly
مراعي: pastures
مربية: nanny
مرة: once
مرة؟: once
مرت: passed
مرتاح: comfortable
مرتاحا: comfortable
مرتبطة: connected
مرتبًا: tidy
مرجل: boiler
مرحبا: hi
مرحباً: hello
مررت: i passed
مررنا: we passed
مرسوم: decree
مرسيليا: marseille
مرشدًا: guide
مرض: illness
مرعى: pasture
مرنة: flexible
مرهقون: are exhausted
مرهمًا: ointment
مرور: passage
مريح: comfortable
مريحة: comfortable
مرير: bitter
مريض: sick
مزاج: mood
مزدحمة: crowded
مزدهرا: prosperous
مزدوج: double
مزدوجة: dual
مزق: rip
مزقها: rip it
مزينة: decorated
مسألة: issue
مسؤولا: responsible
مسؤولاً: responsible
مسؤوليتي: my responsibility
مسار: a path
مساعد: assistant
مساعدة: help
مساعدتك: help you
مساعدتنا: help us
مساعدتها: help her
مساعدتي: help me
مساعدين: assistants
مسافر: traveling
مساهمة: input
مسبقا: advance
مسبقا؟: advance
مسبقًا: in advance
مستعار: wig
مستعد: ready
مستعدا: ready
مستعدان: ready
مستعدة: ready
مستعدون: are ready
مستعدين: ready
مستعدًا: ready
مستقبل: future
مستقبلهم: their future
مستقر: stable
مستلقيا: lying down
مستنقع: swamp
مستيقظ: awake
مسجدهم: their mosque
مسجون: jailed
مسح: survey
مسحة: tinge
مسحور: fascinated
مسحورون: enchanted
مسرور: pleased
مسعود: massoud
مسعور: hydrophobic
مسعور؟: hydrophobic
مسلحين: armed
مسلم: muslim
مسموما: poisoned
مسها: touch it
مشاركة: sharing
مشاعري: my feelings
مشاعري؟: my feelings
مشاكل: problems
مشاكلك: your problems
مشاكله: his problems
مشاكلها: its problems
مشاكلي: my problems
مشاهدة: watch
مشتعلة: flaming
مشغولون: busy
مشقة: discomfort
مشكلة: problem
مشكلة؟: problem
مشكلتك: your problem
مشكلتنا: our problem
مشكلتي: my problem
مشوش: confused
مشيئة: will
مشيت: i walked
مصائد: traps
مصائر: fates
مصاب: injured
مصابة: infected
مصادرها: their sources
مصبوبون: are molded
مصدر: source
مصلحتك: your interest
مصيدة: trap
مصير: fate
مصيرك: your fate
مصيرنا: our destiny
مصيرهم: their fate
مضاءة: lit.
مضرّة: harmful
مضطرب: troubled
مضى: gone
مطارد: stalker
مطاردة: chase
مطحون: ground
مطر: rain
مطلوب: required
مطلوبًا: is required
مظفر: muzaffar
مظلمة: dark
مع: with
معا: together
معارك: battles
معاقبة: punishment
معاملة: treatment
معبأة: packed
معجبون: admire
معجزة: miracle
معدة: stomach
معدتك: your stomach
معرفة: knowledge
معرفتها: know it
معركة: battle
معركتي: my battle
معروف: a favour
معروفا: a favor
معروفة: known
معزولون: isolated
معسكرنا: our camp
معظم: most
معك: with you
معكم: with you
معنا: with us
معنا؟: with us
معنى: meaning of
معه: with him
معها: with her
معها؟: with her
معهم: with them
معي: with me
معي؟: with me
معين: a certain
معًا: together
مغادرة: departure
مغادرون: departing
مغلق: closed
مغلقة: closed
مغلقًا: is closed
مفتاح: a key
مفتوح: open
مفتوحة: open
مفتوحتين: two open
مفتونًا: fascinated
مفر: escaped
مفصولة: separated
مفيدة؟: helpful
مقابل: opposite
مقابلتك: meet you
مقابلته: meet him
مقاومة: resistance
مقبول: acceptable
مقبولة: acceptable
مقتنع: convinced
مقتنعا: convinced
مقتنعا؟: convinced
مقتنعة: convinced
مقتنعون: are convinced
مقدس: sacred
مقدسون: sacred
مقدما: advance
مقر: headquarters
مقر؟: headquarters
مقرنا: our headquarters
مقسمة: divided
مقيدة: restricted
مكان: a place
مكانك: your place
مكانه: status
مكانه؟: status
مكانها: its place
مكانهم: their place
مكاني: my place
مكانًا: a place
مكاوي: irons
مكتملة: completed
مكتملة؟: completed
مكث: stay
مكسورة: broken
مكلف: charged
ملاءمة: relevance
ملائكة: angels
ملابس: clothes
ملاحظة: note
ملاحقتهم: pursue them
ملاديز: maldives
ملاك: angel
ملتوية: crooked
ملتوية؟: crooked
ملك: king
ملكة: queen
ملهمة: inspirational
مليء: full of
مليئة: filled
مليك: malik
مما: than
مماتي: my death
مماثلة: similar
ممارسة: practice
ممتن: grateful
ممكن: maybe
ممكنا: possible
ممكنة: possible
مملة: boring
مملكته: his kingdom
مميتة: lethal
من: from
من؟: from
منا: from u.s
منابر: platforms
مناخات: climates
منازل؟: houses
مناسب: appropriate
مناسبا: suitable
مناسبة: occasion
مناسبًا: suitable
مناقشة: debate
منبر: platform
منتصرا؟: victorious
منتصرين: are victors
منتصف: mid
منتصفها: middle of it
منتعشة: refreshed
منحك: granted
منحني: curve
منحهم: give them
منحى: turn
منخفضة: low
مندهش: surprised
مندهشا: amazed
مندهشًا: surprised
منذ: ago
منزل: a house
منزل؟: a house
منزلاً: house
منزلك: your home
منزلنا: our house
منزلي: household
منزلًا: house
منشفة: a towel
منصة: platform
منطق: logic
منطقة: area
منطقتك: your area
منع: block
منفصلون: separated
منك: from you
منك؟: from you
منكم: of you
منه: from him
منه؟: from him
منها: of which
منهم: who are they
منهما: who are they
مني: mona
مني؟: mona
مهاجمة: attack
مهب: blown
مهتمين: interested
مهرج: clown
مهم: important
مهما: whatever
مهمة: mission
مهمتك: your task
مهمتنا: our mission
مهودهم: their cots
مواجهة: confrontation
موت: death
موتك: your death
موته: his death
موتي: my death
موثوق: reliable
موجود: existing
موحدا: unified
موحدة: uniform
موسى: moses
موضح: explained
موضع: position
موضوع: theme
موضوعًا: topic
موعد: an appointment
موقف: attitude
موقفها: its position
مولعا: fond of
مونتين: montaigne
مونتينس: montens
ميت: dead
ميتا: dead
ميزان: balance
ميليك: melek
نأتي: we come
نأخذ: we take
نأخذه: we take it
نأخذهم: take them
نأسف: sorry
نأمل: hopefully
نائم؟: sleeping
نائما: sleeping
ناحية: hand
نادر: rare
نار: fire
نارنا: our fire
ناصر: naser
ناصر؟: naser
ناقشنا: we discussed
ناقلات: vector
ناهيك: not to mention
نبارك: bless
نباركهم: bless them
نبدأ: we start
نبقى: we stay
نبيع: we sell
نبيل: nabil
نبيلة: noble
نتأخر: be late
نتألم: we suffer
نتجاوز: we go over
نتحدث: we are talking
نتحرك: we move
نتخذه: we take it
نتخلى: we give up
نترك: we leave
نتزوج: we get married
نتزوجك: we marry you
نتصرف: we act
نتعامل: we deal
نتعرف: know
نتعلم: we learn
نتغلب: we overcome
نتف: pluck
نتفق؟: agree
نتلقى: we receive
نتمكن: that we can
نتمنى: we wish
نتوجهم: we are crowning them
نتوق: crave
نتوقع: expect
نتيجة: result
نثق: we trust
نجا: escaped
نجاح: success
نجار: carpenter
نجت: she survived
نجح: he succeeded
نجحت: i passed
نجحنا: we succeeded
نجد: we find
نجعل: we make
نجعلها: we make it
نجل: son
نجلس: we sit
نجوع: hungry
نجينا: we survived
نحارب: we fight
نحافظ: we keep
نحت: sculpture
نحتاج: we need
نحترس: watch out
نحصل: we get
نحمل: we carry
نحن: we
نحوي: grammar
نخاف: we are afraid
نخرج: we go out
نخيم: camp out
ندعك: let you
ندفع: we pay
نذهب: we go
نذهب؟: shall we go
نر: we see
نراق: narcissus
نراكم: see you
نرتاح: rest
نرد: respond
نرسل: we send
نرسلهم: we send them
نرسم: we paint
نركز: we focus
نرى: we see
نرى؟: we see
نريد: we want
نريدك: we want you
نريق: fire
نزال: fight
نزل: download
نزلت: i went down
نسأل: we ask
نستخدمها: we use
نسترجع: we recover
نستطيع: we can
نستقر: we settle down
نستمر: we continue
نستيقظ: we wake up
نسجت: woven
نسفك: torpedoed
نسلم: we recognize
نسلمك: we deliver you
نسمح: we allow
نسمع: we hear
نسمعه: we hear it
نسميه: we call
نسوا: they forgot
نسيان: forget
نسيت: forgot
نسيت؟: forgot
نسير: we walk
نسيم: breeze
نسينا: we forgot
نشأ: starch
نشأت: originated
نشأوا: they have grown up
نشر: spread
نشكر: thank you
نشكرك: thank you
نشيخ: grow old
نصب: set up
نصبت: erected
نصبح: we become
نصبوا: erected
نصدر: we issue
نصل: blade
نصلح: we fix
نصلي: pray
نصنع: we make
نضع: we put
نضعك: we put you
نضفر: plait
نطاق: domain
نظام: system
نظامنا: our system
نظرة: a look
نظرت: i looked
نظرتم: you look
نظرك: your eyesight
نظموا: staged
نظن: we thought
نعامل: we treat
نعامله: treat him
نعبر: we pass
نعتذر: we apologize
نعرف: know
نعرفه: we know
نعرفها: we know it
نعطهم: give them
نعطي: we give
نعطيك: we give you
نعطيهم: we give them
نعلم: we know
نعم: yes
نعم؟: yes
نعمان: noman
نعمة: blessing
نعمل: we work
نعود: get back
نعيش: live
نغادر: we leave
نفترق: we part
نفد: exhaust
نفدت؟: run out
نفس: the same
نفسا: breath
نفسك: yourself
نفسك؟: yourself
نفسه: himself
نفسه؟: himself
نفسها: itself
نفسها؟: itself
نفسي: myself
نفسًا: a breath
نفعل: we do
نفعل؟: we do
نفعله: we do
نفقات: expenses
نفقد: we lose
نفكر: think
نقاتل: we fight
نقبل: accept
نقتل: we kill
نقتلنا: we kill us
نقدية: cash
نقدية؟: cash
نقض: veto
نقطة: point
نقف: stand up
نقل: transfer
نقلقهم: we worry them
نقول: we say
نقوله: we're saying
نكتشف: we discover
نكمل: we complete
نكن: we are
نكون: be
نلتقي: we meet
نلقي: take a
نمت: grown
نمتنع: we refrain
نملة: ant
نمنحه: we grant him
نموت: we die
ننام: we sleep
ننتظر: we wait
ننتقل: we turn
ننتقل؟: we turn
ننجح: we succeed
ننزلق: we slip
ننسى: forget
ننطلق: we go
ننظر: look
ننقذه: save him
نهائي: final
نهاجر: migrate
نهاجم: we attack
نهار: day
نهاية: end
نهايتك: your end
نهب: looting
نهر: river
نهرب: we run away
نهى: forbidden
نواجه: we face
نوايا: intentions
نود: we would like
نور: noor
نوره: nora
نوع: type
نوقشت: discussed
نوم: sleep
نيابة: on behalf of
نيتك: your intention
نيتك؟: your intention
نيته: his intention
نيتهم: their intention
نيتي: my intention
هؤلاء: these
هؤلاء؟: these,
ها: ha
هاتون: hatton
هاتون؟: hatton
هاجرنا: we migrated
هاجم: attacked
هاجمتهم: attacked them
هادئ: quiet
هادئا: quiet
هادئة: quiet
هادئًا: quiet
هارمزشاه: harmsah
هاليم: halim
هاليم؟: halim
هاليمي: halimi
هامة: important
هانم: هانم
هايم: heim
هايم؟: heim
هبوط: drop
هجمات: attacks
هجوم: attack
هدايا: gifts
هدد: threatened
هددت: threatened
هدف: goal
هدفنا: our goal
هدفهم: their goal
هدفي: my goal
هدم: destroy
هدوء: calm
هدير: hadeer
هذا: this
هذا؟: this
هذه: this is
هذه؟: this is
هذين: these two
هرب: escape
هربت: i ran away
هربنا: we ran
هربوا: they fled
هزته: shake it
هزم: defeated
هكذا: so
هكذا،: so,
هكذا؟: so
هل: do
هلك: perish
هم: they
هم؟: they
همسات: whispers
همست: i whispered
هنا: here
هنا؟: here
هناك&quot;: over there&quot;
هناك: over there
هناك؟: there
هو: is
هو؟: is
هواية: hobby
هويات: identities
هوية: identification
هي: she
هي؟: she
هيئة: body
هيا: come on
هيا،: come on,
و: and
وآمالهم: and their hopes
وآمل: i hope
وآمن: and safe
وأبكي: and cry
وأبناؤنا: and our sons
وأبنائنا: and our children
وأبي: and dad
وأبيك: and your father
وأتحدث: and i talk
وأتساءل: i wonder
وأتمنى: i wish
وأحب: and loved
وأحضر: and he brought
وأحفاد: and grandchildren
وأحفادنا: and our grandchildren
وأخبر: he told
وأخبرك: and tell you
وأخبرني: and tell me
وأخبره: and tell him
وأختك: and your sister
وأختي: and my sister
وأخذ: and took
وأخذهم: and took them
وأخي: and my brother
وأدعو: i call
وأذيتك؟: and hurt you
وأراد: and wanted
وأرحل: i am leaving
وأرضنا: and our land
وأسر: and families
وأسلحتهم: and their weapons
وأسمع: and i hear
وأشهد: i bear witness
وأصبحت: and became
وأصلي: and pray
وأطفالي: and my children
وأطلب: i ask
وأطيب: and best
وأعتقد: and i think
وأعطيت: and it was given
وأعظم: and the greatest
وأعمالنا: and our business
وأعود: and come back
وأقتلهم: and kill them
وأقلام: and pens
وأكبر: and bigger
وأكثر: and more
وأكل: and eat
وألتقطهم: and pick them up
وألقوا: and threw
وأنا: and i
وأنا؟: and i
وأنت: and you
وأنتظرك: and waiting for you
وأود: i wish
وإحضاره: and bring it
وإذا: if
وإسقاط: and drop
وإصلاح: and repair
وإلا: otherwise
وإلى: and to
وإنهاء: and finish
وابلغه: and inform him
وابنك: and your son
وابنه: and his son
واتصل: and call
واثقا: confident
واجب: duty
واجباته: his duties
واجباتهم: their duties
واجبك: your duty
واجبنا: our duty
واجبي: my duty
واجلس: sit down
واجه: face
واجهت: you experience
واجهنا: we faced
واجهه: interface
واحتجزوا: they were detained
واحد: one
واحدا: one
واحدة: one
واحدة؟: one
واحدًا: one
واحصل: and get
واحضرهم: and bring them
واختبأته: and hid him
واختبرنا: and we tested
واختطاف: and kidnapping
واخرج: and get out
واخي: and my brother
وارتكب: and committed
واسألهم: and ask them
واسترح: and take a rest
واستريح: and rest
واستسلم: he surrendered
واستعد: and get ready
واستفسرت: she inquired
واسمحوا: let
واصلتم: you keep
واضح: clear
واضح،: clear,
واضحة: clear
واطلب: and ask
واعلم: and i know
والآخر: and the other
والآن: and now
والأحفاد: and grandchildren
والأرض: and earth
والأسلحة: and weapons
والأشخاص: and people
والأظافر: and nails
والأفضل: and the best
والأكاذيب: and lies
والأكثر: and most
والإسلام: and islam
والابتعاد: and get away
والاختباء: and hide
والادخار: and savings
والاستسلام: and surrender
والانتعاش: and recovery
والانضمام: and join
والانفصال: and separation
والباقي: and the rest
والبحار: and the seas
والبدء: and start
والبكاء: and cry
والبنادقة: and the venetians
والبندقية: and the gun
والتجهم: and grimaces
والتحدث: and talk
والتحقق: and check
والتصرف: and act
والتضحية: and sacrifice
والتفكير: and thinking
والتقاليد: and traditions
والتي: and that
والثاني: and the second
والثروة: and wealth
والجلوس: and sit down
والجنازات: and funerals
والحديث: and talk
والحروف: and letters
والحصول: and get
والحفاظ: and keep
والحكم: and governance
والحل: and the solution
والحمد: and praise
والخانات: and khans
والخروج: and get out
والخوف: and fear
والخيام: and tents
والد: father
والدببة: and bears
والدة: mother
والدتك: your mom
والدتنا: our mother
والدته: his mother
والدتها: her mother
والدتي: my mother
والدروع: and armor
والدك: your father
والدك؟: your father
والدنا: our father
والده: mother
والدها: her dad
والدها؟: her dad
والدي: my father
والدي؟: my father
والذين: and who
والراحة: and rest
والرحمة: and compassion
والرد: and reply
والرقصات: and dances
والرموش: and eyelashes
والروح: and soul
والسلاطين: and sultans
والسلام: and peace
والسماء: and the sky
والسماح: and let
والسهم: and arrow
والسيف: and the sword
والشتاء: and winter
والشتائم: and swearing
والشجاع: and brave
والشجاعة: and courage
والشخصيات: and characters
والشرف: and honor
والشكوك: and doubts
والشهداء: and martyrs
والشيء: and the thing
والصبر: and patience
والصلاة: and pray
والصليبيون: and the crusaders
والعافية: and wellness
والعمل: and work
والعودة: and return
والغربان: and crows
والغزو: and invasion
والقادم: and the next
والقتل: and murder
والقدس: and jerusalem
والقدمين: and feet
والقلب: and heart
والكلاب: and dogs
والله: i swear
والماء: and water
والمارسيليا: and marseille
والمتسولين: and beggars
والمحاربين: and warriors
والمشي: and walking
والمطاردة: and chase
والموت: and death
والناس: and people
والنبي: and prophet
والنسور: and eagles
والهجرة: and immigration
والهرب: and escape
والواقع: and indeed
والوجهة: and destination
والوصول: and access
والوقوف: and stand up
واملأ: and fill
وانام: i sleep
وانت: and you
وانتظار: and waiting
وانتقل: and go
وانظر: and see
وانقاذ: and save
وانهار: and collapsed
وايلد: wilde
وبارك: and bless
وبالتالي؟: and therefore
وبالفعل: and indeed
وباي: and ebay
وبدأت: and started
وبركاته: and blessings
وبركة: and pool
وبعبارة: in words
وبناء: and build
وبناتنا: and our daughters
وبهذه: and with this
وبيعت: and sold out
وتأكل: and eat
وتباع: and sold
وتتصرف: and behave
وتثق: and you trust
وتجعلك: and make you
وتحترق: and it burns
وتحدث: he spoke
وتحقق: and check
وتحولت: and turned
وتحويله: and convert it
وتحويلها: and turn it
وتدمير: and destroy
وتذهب: and go
وتذهب؟: and go
وتربك: and confuse
وترتيب: and arrange
وترعرعنا: we grew up
وترك: and leave
وترك؟: and leave
وتركني: he left me
وتسعين: ninety
وتسليمه: and hand it over
وتسليمها: and delivered
وتسمح: and allow
وتسمين: and fattening
وتشاهد: and you see
وتصبح: and become
وتضمنت: included
وتعالى: almighty
وتعامل: and treated
وتعرف: and you know
وتعود: and come back
وتغسل: and wash
وتفوح: and smelt
وتقديم: and deliver
وتقول: she says
وتكرارا: and over again
وتكون: and be
وتلجأ: and resort
وتنام: and you sleep
وتهاجر: and migrate
وتورجوت: and turgut
وثق: trust
وثقت: documented
وثم؟: and then
وثيقة: document
وجاء: and came
وجبال: and mountains
وجد: is found
وجدت: have found
وجدت؟: have found
وجدنا: we found
وجدناه: we found it
وجدناها: we found it
وجع: ache
وجعلت: and made
وجعلك: and made you
وجعلني: and it made me
وجعلها: and make it
وجعلهم: and make them
وجلب: and bring
وجلس: and sat down
وجمعهم: and gather them
وجميع: and all
وجه: face
وجها: a face
وجهات: destinations
وجهاً: face
وجهتنا: our destination
وجهتهم: their destination
وجهتي: my destination
وجهك: your face
وجهه: his face
وجهها: her face
وجهي: my face
وجود: presence
وجودي: my presence
وجوكسي: and juxi
وجيزة: brief
وجيه: facet
وحتى: and even
وحدة: alone
وحدك: alone
وحدنا: alone
وحده: alone
وحدها: alone
وحدهم: alone
وحدي: alone
وحرق: and burn
وحشية: brutality
وحظر: and ban
وحكمك: and your judgment
وحلب: and aleppo
وحمتنا: and protect us
وحملهم: and get them
وحياة: and life
وحياتنا: and our lives
وحياتي: and my life
وحيدا: lonely
وحيدة: lonely
وخارج: and out
وخارجها: and beyond
وخاصة: especially
وخدمة: and service
وخدين: and cheeks
وخيانة: and betrayal
وداع: farewell
وداعا: goodbye
وداعًا: goodbye
ودعا: called
ودفعت: and pushed
ودمرت: and destroyed
ودوجان: and dogan
ودوغان: and dogan
وذبح: and slaughter
وذبحوا: and slaughtered
وذريتي: and my offspring
وذهبت: and i went
ورأيته: and i saw him
ورؤية: and see
ورؤيتك: and see you
وراء: behind
وراءه: behind him
وراءهم: behind them
ورائك: behind you
ورائنا: behind us
ورائهم؟: behind them
ورحمة: and mercy
وردة: a rose
ورسوله: and his messenger
ورشة: workshop
ورشتي: my workshop
ورطة: dilemma
ورطة؟: dilemma
ورغباتنا: and our desires
ورفيقه: and companion
ورفيقي: and my companion
ورقة: a sheet
وركب: and rode
وزن: weight
وزوجتك: and your wife
وزير: minister
وسأكون: and i'll be
وسألني: he asked me
وساني: and my tongue
وستجلبه: it will bring
وسجل: scored
وسحب: and pull
وسحقك: and crush you
وسط: center
وسعك: your power
وسعه: his power
وسعي: and my power
وسعيدة: and happy
وسفك: and shedding
وسلامة: and safety
وسلم: and blessings
وسليم: and sound
وسليمان: and solomon
وسليمة: and sound
وسليمًا: and sound
وسنرافقك: we will accompany you
وسهلا: and easy
وسوف: will
وسيلة: instrument
وشأننا؟: like
وشاه: and shah
وشاهزاد: and shahzad
وشاهزاده: and shahzadeh
وشاهنا: and shahinah
وشجاعة: and courage
وشجاعتك: and your courage
وشرب: and drink
وشرفك: and your honor
وشقيقتنا: and our sister
وشقيقته: and his sister
وشك: about
وشوهد: it was seen
وشيء: and something
وشيكة: imminent
وصادق: and honest
وصل: arrive
وصلت: reached
وصلنا: we arrived
وصوت: and a voice
وصولا: right up
وصوله: arrival
وصيته: his will
وصيد: and hunting
وضرب: and hit
وضع: put
وضعت: put
وضعنا: we put
وضعناها: we set
وضعه؟: put it
وضعها: put it down
وطفلك: and your child
وطلب: and asked
وطن: homeland
وطننا: our home
وظائف: careers
وظائفنا: our jobs
وظيفة: function
وظيفتها: its function
وظيفتي: my job
وعائلة: and family
وعائلته: and his family
وعائلتها: and her family
وعادنا: and we returned
وعد: promise
وعدتني: she promised me
وعدك: your promise
وعدني: promise me
وعديم: and nonsense
وعلاوة: furthermore
وعمه: and uncle
وعن: and about
وعودة: and return
وعينيك: and your eyes
وعيون: and eyes
وغفر: and forgiven
وغيرها: and others
وفاة: death
وفاتهم: they died
وفتح: and open
وفرسان: and knights
وفقا: according
وفقكم: may you
وفهمتني: and you understand me
وفي: and in
وقائده: and its leader
وقائده؟: and his commander
وقائي: preventive
وقاحة: effrontery
وقاسية: and harsh
وقال: and he said
وقالت: she said
وقبلت: and accepted
وقبلنا: and we accepted
وقت: time
وقت؟: time
وقتا: time
وقتل: he was killed
وقته: his time
وقح: shameless
وقد: and also
وقراءة: and read
وقسوة: and cruelty
وقطاع: and strip
وقطعانهم: and their herds
وقعت: occurred
وقعنا: we caught
وقف: stood up
وقف،: stood up,
وقفت: i stood up
وقل: and say
وقم: and do
وقوتي: and my strength
وكأن: as if
وكأنك: like you
وكأنها: like
وكاملة: and complete
وكان: it was
وكانت: she was
وكذلك: as well
وكسر: and break
وكشفت: revealed
وكل: and all
وكلماتك: and your words
وكن: and be
وكيف: and how
وكيفية: and how
ولأبنائي: and for my children
ولأجلي: and for me
ولأطفالنا: and for our children
ولا: nor
ولائك: your loyalty
ولادة: birth
ولايتي: my state
ولت: gone are
ولختي: and my sister
ولد: boy
ولد؟: boy
ولدت: i was born
ولدنا: we were born
ولدي: and i have
ولديه: and has
ولك: and for you
ولكم: and you
ولكن: but
ولكنك: but you
ولكنه: but it is
ولم: and did not
ولماذا: and why
ولماذا؟: and why
ولن: it will not
وله: and him
ولو: though
وليس: and not
وليمة: feast
وما: gesticulate
وماذا: and what
وماست: and mast
ومحاربة: and fight
ومخلص: and sincere
ومساعدتي: and help me
ومستقبل: and the future
ومطاردتي: and chase me
ومع: still
ومعاقبتهم: and punish them
ومن: and from
ومنحهم: and give them
ومهاجمة: and attack
ومهارتك: and your skill
ونأكل: and eat
ونأمل: and we hope
ونتحدث: and we talk
ونتوقع: and expect
ونحصل: and we get
ونحن: and we
ونرى: and see
ونشأنا: and we grew up
ونضارتها: and freshness
ونظام: and system
ونعود: and come back
ونفرح: and rejoice
ونفسك: and yourself
ونقول: and we say
ونموت: and die
ونهارا: and day
وهاتون؟: and hatton
وهاليم: and halim
وهاليمي: and halimi
وهبنا: give us
وهذا: and this is
وهذه: and this
وهربت: and ran away
وهكذا: and so on
وهل: and does it
وهم: they are
وهمًا: illusion
وهو: and he
وهي: which
ووالدتك: and your mom
ووجدوا: and they found
ووجه: he drew
ووحدة: and unity
ووضع: and put
ووضعها: and put it
ووفاته: and his death
ووقف: and stop
وولف: wolf
ويأخذك: and take you
ويتصرف: and acting
ويجب: a must
ويجري: being
ويساعدنا: and help us
ويسمى: is called
ويصبح: it becomes
ويعتقد: believe
ويغيت: weightgate
ويقولون: and they say
ويكون: and be
ويمكن: it can
ويمكنك: and you can
وينبغي: should
يأتي: come
يأخذ: takes
يأخذك: takes you
يأخذه: take it
يأخذها: take her
يأخذهم: take them
يأخذوك: they take you
يأخذون: taking
يأخذونك: they take you
يأخذوننا: they take us
يأكل: eat
يأمر: ordering
يؤثر: influence
يؤجج: inflames
يؤدي: lead
يؤذيك: hurt you
يؤذينا؟: hurt us
يا: oh
يائس: desperate
يائسا: desperate
يائسة: desperate
يائسًا: desperate
ياله: hey
يبارك: bless
يباركنا: bless us
يباركه: bless him
يبحث: he searches
يبحثون: they are looking
يبدأ: started
يبدو: sound
يبشر: heralds
يبق: remains
يبقون: they stay
يبقى: remains
يبقي: remains
يبقينا: keep us
يبقيه: keep it up
يبكين: crying
يبيع: selling
يتأخر: delayed
يتأكدون: they make sure
يتألم: hurt
يتبعونني: they follow me
يتبق: remain
يتجاوز: exceed
يتجمعون: congregate
يتجه: is heading
يتجول: wandering
يتجولون: walk around
يتحد: unites
يتحدث: speaking
يتحدثان: they talk
يتحدثون: they speak
يتحدون: they challenge
يتحسن: is getting better
يتحول: turns up
يتحولون: they turn
يتخطى: skips
يتذكر: he remembers
يتراجع: retreat
يترددون: they hesitate
يترك: leaves
يتركني: he leaves me
يتركون: they leave
يتزوج: get married
يتزوجون: get married
يتسرب: leak out
يتسللون: they sneak
يتشابك: intertwined
يتشبث: clinging
يتصرف: behave
يتصرفون: they are acting
يتضايقون: they get upset
يتضرر: be hurt
يتضور: is attending
يتضورون: sitting
يتطلب: requires
يتعافى: recovering
يتعامل: dealing
يتعاون: cooperates
يتعرض: exposed
يتعلق: regard
يتعين: should
يتغير: is changing
يتفق: agree
يتكون: consists
يتم: complete
يتمتع: enjoy
يتمكن: manage
يتمكنوا: they can
يتنفس: breathes
يتهمني: accuse me
يتهمون: they accuse
يتوقع: expect
يتوقعون: they expect
يتوقون: yearn
يتيح: lets
يثق: trust
يجب: should
يجتمع: meets
يجتمعوا: they get together
يجتمعون: they meet
يجد: find
يجدنا: find us
يجدون: they find
يجرؤ: dare
يجري: being
يجعل: makes
يجعلك: make you
يجعلني: makes me
يجلب: brings
يجلس: sitting
يجيت: يجيت
يجيت؟: yigit
يحارب: fights
يحافظ: maintains
يحاكم: be tried
يحاكم؟: tried
يحاول: try
يحب: likes
يحبنا: loves us
يحتاج: need
يحتاجون: they need
يحتاجونه: they need
يحتجزون: they are holding
يحتجزونك: they are holding you
يحترق: burning
يحترم: respects
يحترمهم: respects them
يحتلها: occupied by
يحدث: happen or occur
يحدث،: happen or occur,
يحدث؟: happen or occur
يحرس: guards
يحرسهم: guarding them
يحرق: burn
يحزن: grieves
يحصل: gets
يحصلون: they get
يحضر: bring
يحفظك: saves you
يحلو: she likes
يحمل&quot;: carry&quot;
يحمل: carry
يحمي: protect
يحميك: protects you
يحمينا: protect us
يحولها: turn it
يحيا: long live
يحين: it comes
يحيى: yahia
يحيي: yahia
يخاطر: take risks
يخاف: afraid
يخافون: they are afraid
يخبئه: hide it
يخبرنا: tell us
يخبرني: tell me
يخبرون: they tell
يختار: choose
يختبئ: hiding
يختبئون: hiding
يختبر: tests
يختلف: differs
يخجل: ashamed
يخدع: deceive
يخدمهم: serve them
يخرج: out
يخسر: loses
يخسرون: they lose
يخضع: subject
يخفيها: hides it
يخلق: creates
يخون: betray
يخيف: scare
يد: hand
يداك: your hands
يدخل: enters
يدخلون: they enter
يدرك: realize
يدري: who knows
يدعو: calls
يدعوك: invites you
يدعى: he claims
يدفع: pay
يدفعون: they pay
يدور: spins
يدي: my hand
يدير: manages
يديك: your hands
يديها: her hands
يذكر: mentionsed
يذهب: he goes
يذهبون: they go
يرافقني: accompany me
يراك: see you
يرام: okay
يراهم: he sees them
يربط: attach
يربطها: connects them
يربكه: baffle it
يرتجف: trembling
يرتجفون: trembling
يرتدي: dressed
يرتدي؟: dressed
يرجى: kindly
يرحمنا: have mercy on us
يرزقنا: bless us
يرسل؟: sends
يرغب: wishes
يركب: riding
يركب؟: riding
يركبه: install it
يركض: running around
يره: see him
يرها: he sees it
يروا: they see
يرى: be seen
يريحنا: it relieves us
يريد: wants
يريدهم: he wants them
يريدون: they want
يزال: still
يزداد: is increasing
يزدادون: they are getting
يزرع: planting
يزرني: visit me
يزعجك؟: bother
يزعجني: bothers me
يسأل: asks
يسألني: ask me
يساعد: helps
يساعدك: helps you
يساعده: help him
يساعدوننا: help us
يسامحني: forgive me
يسبب: it causes
يسبق: precedes
يستحق: deserves
يستحق؟: deserves
يستحقون: they deserve
يستديرون: turn around
يستريح: rest
يستريحون: resting
يستسلم: give up
يستطع: he can
يستطيع: can
يستطيعون: they can
يستعدان: preparing
يستعدوا: brace
يستعدون: they are preparing
يستفيد: benefits
يستمتعون: they enjoy
يستمر: continue
يستمع: listen
يستيقظ: wakes up
يستيقظ؟: wakes up
يسجنهم: imprison them
يسحب: pulls up
يسعدني: i am pleased
يسفك: shed
يسقط: drops
يسكب: pour
يسكن: live
يسلموا: they deliver
يسمح: allow
يسمع: hears
يسمعك: hear you
يسمعونك: they hear you
يسمونك: they call you
يسمونه: they call it
يسمى: he is called
يسهب: dwells
يسهل: easy
يسوع: jesus
يسير: walking
يسيطر: controlled
يشاركني: share me
يشاهدون: they watch
يشبه: resembles
يشتبه: suspected
يشرق: shines
يشعرون: they feel
يشفيه: heal him
يشك: doubt
يشكو: to complain
يشمل: includes
يصابون: they get infected
يصبح: become
يصدق: believe
يصرخ: shout
يصطاد: catch
يصف: describe
يصل: reaches
يصنع: make
يصهل: smooth out
يضايقنا؟: bother us
يضحى: sacrifice
يضحيه: sacrifice
يضر: harms
يضرب: hits
يضع: put
يضعفون: weaken
يضعها: puts it
يضيء: shines
يضيع: lose
يضيعون: they are wasting
يطاردهم: chasing them
يطبخ: cooking
يطرق: knocking
يطلب: requests
يطلق: launch
يطهى: cook
يطير: flies
يظهر: shows
يعارض: oppose
يعاقب: punish
يعاملوه: treat him
يعاني: suffers
يعبث: mess around
يعتاد: get used
يعترض: object
يعترض؟: object
يعتقد: believes
يعتقدون: they think
يعتمد: relies
يعتنون: they take care
يعتني: takes care
يعج: teeming
يعجبك: you like it
يعد: prepare
يعرف: known
يعرفون: they know
يعرفونني؟: know me
يعرفوها: they know
يعزز: enhances
يعطونه: they give it
يعطى: give
يعطي: give
يعطيك: gives you
يعطينا: give us
يعطيني: give me
يعطيه: give him
يعطيهم: give them
يعقوب: yacoub
يعلم: know
يعمل: works
يعني: means
يعود: returns
يعودون: they come back
يعيدني: take me back
يعيش: live
يعيشه: live it
يعيشون: they live
يعيقنا: hinders us
يعينك: help you
يغادر: leaves
يغرق: drown
يغفر: forgive
يغلقون: they close
يغيت: leggett
يغيت؟: leighgate
يفاجأ: be surprised
يفتح: opens
يفترض: supposedly
يفرون: they are fleeing
يفرون؟: fleeing
يفضل: preferably
يفعل: do
يفعل؟: do
يفعله: he does
يفعلوا: they do
يفعلون: they do
يفكر: think
يفكرون: they think
يفلت: get away
يفلح: it works
يفهموا: they understand
يفوتوني: they miss me
يفوز: wins
يفيض: overflows
يقاتلون: they fight
يقال: it said
يقاوم: withstands
يقبل: accepts
يقتل: kill
يقتلك: kills you
يقتلك؟: kills you
يقتلني: killing me
يقتلون: they are killed
يقتلوني: they kill me
يقدر: appreciate
يقدم: offers
يقدمون: they offer
يقرأ: is reading
يقرر: decide
يقضي: spends
يقع: located
يقف: stands up
يقلقك؟: worries
يقلقني: it worries me
يقلوا: say
يقهر: invincible
يقود: driving
يقودني: lead me
يقودهم: lead them
يقول: says
يقوله: he says
يقولوا: they say
يقولون: they say
يقوم: is based
يقوموا: they shall
يقيمون: they reside
يكبر: grow up
يكتب: writes
يكرم: honour
يكسر: breaks
يكفي: enough
يكن: not
يكون: is being
يكون؟: is being
يكونوا: they are
يلتف: wraps
يلجأ: he turns
يلعبون: they play
يلفت: draws
يلقي: cast
يلمع: shine
يليق: befitting
يمت: is dead
يمتنعوا: abstain
يمر: passes
يمرون: they pass
يمسك: catch
يمضون: they spend
يمكن: can
يمكنك: you may
يمكننا: we can
يمكنني: i can
يمكنه: he can
يمكنها: it can
يمكنهم: they can
يملأ: filling up
يمنح: granted
يمنحها: give it
يمنعنا: stop us
يمهد: paving
يموت: dies
يموتون: they die
ينادي: calling
يناسب: suits
يناسبك: suits you
ينام: sleeping
ينامون: they sleep
ينبح: barking
ينبض: beat
ينبغي: should
ينتشر: spread out
ينتظر: waiting
ينتظرك: awaits you
ينتظرنا: waiting for us
ينتظرون: they are waiting
ينتمون: they belong
ينتمي: belongs
ينتهك: violates
ينتهي: finish
ينجح: succeed
ينجي: wenge
ينجي؟: wenge
ينسى: forget
ينضم: joins
ينطق: utters
ينظر: look
ينفصل: separates
ينقذ: save
ينقذنا: save us
ينقصه: is lacking
ينقلون: they carry
ينمو: grows
ينهار: collapses
ينهون: they finish
يهاجر: migrates
يهاجم: attack
يهاجموننا: they attack us
يهتم: cares about
يهتمون: they care
يهدأ: calms down
يهرب: escape from
يهربوا: run away
يهربون: they run away
يهز: shake
يهم: matter
يهمك: you care
يهملني: neglects me
يهمني: i care about
يواجه: faces
يواجهني: face me
يواجههم: face them
يواجهون: they face
يوجد: exist
يوحد: unites
يود: would like
يوسف: youssef
يوفقك: help you
يوفقنا: help us
يوفقهم: help them
يوم: day
يوم؟: day
يوما: days
يومان: tow days
يومك: your day
يومنا: our day
يومين: two days
يومين؟: two days
يومًا: days
