حيوانات: animals
بحاجة: need
سأزودها: i'll supply it
كلها: all of which
عزام: عزام free membership
لقد: lhave
حق: right
المدللين: pampered
يحافظ: maintains
تحظى: have
يعلم: know
السوق: market
تصرخ: scream
جانبنا: our side
تاريخنا: our history
السلطان: sultan
للبابا: for the pope
شخصياً: personally
سمعت: i heard
الماجستير: masters
اقتل: kill
لدينا: we've got
الحيوانات: the animals
استخدام: use
نكون: be
يمكن: can
بالفعل: indeed
حبيبي: baby
المناسب: the appropriate
غدًا: tomorrow
تحرير: release
webvtt: webvtt
للأيام: for days
ل: to
قبول: acceptance
لإقامة: to set up
يقلوا: say
الصليبية: crusade
السيطرة: the control
هم: they
هل: do you
نهب: looting
قوتهم: their strength
بلدي: my country
لذلك: so
رجالك: your men
انهم: that they
هي: she
هو: he is
عالمي: my world
يعتمد: relies
غضب: anger
وقت: time
الأب: the father
المناطق: regions
للهجوم: to attack
جوندوجو؟: gundogo?
بني: brouwn
السهل: easy
تسفك: shed
قبيلة؟: tribe?
جنبا: side
نحن: we
أرغب: i want
غرفتك: your room
الألب: alps
أموالنا: our money
الحملة: the campaign
للأمراء: for princes
رئيس: president
العظيم: great
قريبًا: soon
نعيش: live
عيون: eyes
اهلا: welcome
للقلق: to worry
الجزر: carrots
يغيت: leggett
سأخبرك: i will tell you
سيدك: your master
المعابد؟: temples?
دائمًا: always
السيئة: the bad
النوع: type
الذين: whose
خيمته: his tent
معهم: with them
قدمًا: ahead
غضنفر: ghazanfar
كوردوغلو: kordoglu
انا: i am
كما: as such
لدي: i have
من: from
وجهتنا: our destination
الفقار: spondylitis
حتى: until
استدعاء: call up
لذا: so
الساق: the leg
رائع: fabulous
قريباً: soon
نعم؟: yeah?
اهرب: run away
ذو: thou
نقدية؟: cash?
إلهام: important
أرجو: please
أي: which
حلب: aleppo
أو: or
مألوفة: familiar
نشكر: thank you
لإيجاد: to find
لتناول: to take up
أتمنى: i wish
السلجوقية: seljuk
أن: that
الإله: god
رمضان: ramadan
أقصر: shorter
هيا: come on
الأستاذ: the professor
السوداء: black
حالة: status
يأخذها: take her
أعطهم: give them
يعطونه: they give it
باحترام: respectfully
سيتعلم: will learn
تهدئة: calm down
لجميع: for all
تذرف: shedding
هؤلاء؟،: these?,
القدوم: arrival
مشكلة: problem
للذهاب: to go
للتضحية: to sacrifice
أبداً: start
أدع: i pray
لله: allah
،،: ,,
اكتشاف: discovery
الجمال: beauty
ويتصرف: and acting
يدعو: calls
تحتاج: need
بكل: all
أبى: my father
أحضر: brought
بيسول: bessol
ذلك: that
engb: engb
إنه: it's a
الخاص: the private
الأمراء: princes
الأمر: command
المستحيل: impossible
دائما: always
جديدة: new
الشرف: honour
ذاهب: going
كن: be
كم: how many
قريبا: soon
وجعلهم: and make them
المضي: go ahead
احضرت: i brought
السلاطين: sultans
شجاع: brave
اثنان: two
روزالينا: rosalina
أخرى: other
إرتوغرول: ertugrul
بعيدًا: away
نترك: we leave
المكان؟،: place?,
صربية: serbian
الرجال: men
أفضل: best
تذهب: you go
بك؟: your?
لديك: you have
اخترت: i chose
الأثناء،: meanwhile,
ليكون: to be
سيقدمون: they will give
دموعنا: our tears
سنجد: we will find
نثق: we trust
بك،: bey,
أكبر: larger
يبدأ: started
الاشقر؟: blond?
يضيعون: they are wasting
المحيطة: surrounding
شخصا: people
كبرياءك: your pride
الأوان: time
كايي: kaye
مرة: once
؟،: ?,
الغزو: invasion
بفضل: thanks to
ساعدهم: help them
أرواح: spirits
آمنة: safe
حسنا؟،: ok?,
عمّنا: our uncle
باسمك: in your name
أسفل: down
تشتعل: ignite
أولئك: those
نصل: blade
تعرضوا: they were exposed
الاستعداد: getting ready
شاه: shah
لتأخذها: to take them
القافلة: the convoy
elanora: elanora
رأينا: we saw
كامرأة؟: as a woman?
نصبوا: erected
أحرار: are free
فات: rolls
حريص: careful
العناء: the trouble
الجرح: the wound
لأكاكوكا: for akakuka
كبير: large
يائس: desperate
القبيلة: the tribe
القبائل: tribes
نظرتم: you look
سلطان: sultan
اخي: brother
وسوف: will
مدينون: owe it
إليه: mechanism
نصنع: we make
سيريحنا: he will comfort us
كل: all
الأتراك: turks
البعض: other
آمل: hopefull
سيكون: will be
بامسي: bamsey
اهلا،: welcome,
صحة: health
الطغاة: tyrants
وهذه: and this
النيران: flames
الجبال: mountains
باسم: basim
ماسة: desperately
تنتقل: move
أعتقد: think
جوعك: your hunger
بالنسبة: for
أختنا: our sister
تنتظرنا: waiting for us
انظر: look
قصرنا: our palace
قبلت: accepted
يحلو: she likes
هناك: over there
للحصول: to get
مضى: gone
ليس: not
حاولت: i tried
الحلفاء: allies
إلا: except
شرفك: your honor
الناس؟: people?
بعضنا: each other
تتمنا،: wishes,
اللحم؟: the meat?
فإن: the
موتك: your death
تحرك: move
الخيول: horses
اشتريتها: bought it
والدي: my dad
جاهزة: ready
إله: machine
تدعني: let me
و: and
والدك: your father
إلى: to me
لوحدك: on your own
لهما: for them
أثناء: during
ابن: son
غداً: tomorrow
الكاتالونيون: catalans
ابق: stay
كبار: senior
نهاجر: migrate
فرسان: knights
تلبي: meet
أغلى: more expensive
أحررها: edit it
الابن: son
وهذا: and this is
القيمة: the value
غادر: leave
قد: may be
يستطع: he can
دعنا: let's
المستنقعات: swamps
وضع: put
والبندقية: and the gun
سريعًا: soon
جوعا: starvation
نصلح: we fix
أردنا: we wanted
تحياتي: greetings
النزيف: bleeding
يسيطر: controlled
ثم: then
أجل: yes
gundogdu: gundogdu
الهرب: run away
يجلس: sitting
المدينة: city
معنا: with us
جيدًا: well
تأجيج: kindle
80: 80
علاء: alaa
صليبي: crusader
القصص: stories
خذنا: take us
أنت: you are
ونظام: and system
القصر: the palace
شكراً: thanks
أنا: i am
مثل: like
تخلص: get rid
لكنها: but she
واحدة: one
تحديد: determination
تشغيل: operation
اذهب: go
فتاتي: my girl
كشك: booth
السيف: sword
العيون: the eyes
الأنفاس: breaths
أبي؟: my father?
البحر: the sea
بالحياة: in life
الأناضول: anatolia
جيد: good
مندهشًا: surprised
احصل: get
سيدي: sir
القيامة: resurrection
بتدريبها: train them
ولأجلي: and for me
أوقات: times
إننا: we are
يمكنك: you may
للأكل: to eat
نادر: rare
قمت: you've
يفعلون: they do
السلام: peace
الصغيرة: small
قدمنا: we introduced
جميعًا: all of them
سلام: peace
متحالفًا: allied
حملة: campaign
استعداد: ready
كافية،: enough,
الأرثوذكس: orthodox
المرة: time
الحديد: iron
ترغب: wish
أبي: my father
سمح: allowed
العدو: the enemy
وجلس: and sat down
الصخرة: the rock
الصيد: the hunt
الآب،: the father,
جزيلا: so much
الرئيسي: the main
الماء: water
الفوز: the win
الفور: the spot
مفر: escaped
تقلق: worry
أوروبا: europe
karatoygar: karatoygar
شيء: thing
سابق: former
نرتاح: rest
المحكمة: court
البرية: wild
بعث: he sent
ومع: still
البضائع: the goods
السعادة: happinese
كذلك؟: as well?
بعضهم: some of them
اللاتين: latins
لإنقاذ: to save
بعض: some
المنطقة: region
الدين: religion
لنا: our
حدث؟،: event?,
كذلك: as well
ديوننا: our debts
الرحلة: the journey
قليلا: a little
العام: year
الواجب: homework
الرقيق: the kind
ضائع: lost
الخيام؟: tents?
أيهم: ayham
قبل: before
لنقوم: let's
فضلك: please
أكاكوكا: akakuka
غبية: stupid
تنقذهم؟: save them?
البحث: search
وسهلا: and easy
ملك: king
نبدأ: we start
هيا،: come on,
الآن: right now
تزعجني: disturb me
سريع: fast
المال: the money
ليكن: let it be
تاجرًا: merchant
جوعًا: starvation
ertugrul: ertugrul
والمارسيليا: and marseille
قائد؟: leader?
ماذا: what
المرتفعات: highland
المفتاح: the key
تاجر: dealer
أعطاك: he gave you
هدفنا: our goal
يوم: day
ولدنا: we were born
أبلغ: inform
كنا: we were
بذلك،: so,
تركك: leaving you
الإمكان: possible
والأحفاد: and grandchildren
الأمور: things
لست: i'm not
تستحق: well worth
متلهفين: eager
بالقلق: worried
مقابلته: meet him
تتغير: are changing
وقراءة: and read
تصبح: become
kayi: kayi
لاحقًا: later
نعم: yeah
للبيع: for sale
أمانًا: secure
الجميلة: the beautiful
المضطهدين: the oppressed
تجلب: bring
أنهم: that they
الصليبيون: the crusaders
قابلة: met him
فالقبيلة: the tribe
هادئ: quiet
ذات: related
1225: 1225
عبدا: a slave
المهم: the important
بالقرب: near
يكن: not
المسلمون: muslims
أقول: i say
وشرفك: and your honor
مفتاح: a key
تريد: you want
وكان: it was
سوى: but
أنك: that you are
غزانفر: ghazanfar
لواء: major general
ثروة: wealth
معه: with him
لأخي: for my brother
نقدية: cash
تخون: betray
تعليق: suspension
تحدث: talk
يرجى: kindly
أيضا: also
رحلتك: your journey
للسيطرة: to control
سيتم: will be
بنفسي: by myself
يجب: should
قل: say
حلاً: a solution
لصالح: favor
بثلاثة: with three
بإذنكم: with your permission
زرع: planting
لهذا: for this
ستكون: it will be
محكمة: court
أغنياء: rich
فليكن: let it be
غير: non
الأب،: the father,
الاطمئنان: reassurance
يمكننا: we can
تنجح: succeed
الكثير: lots
الساخن: hot
للمحتاجين: for the needy
لتزويدهم: to provide them
سليمان: sulaiman
قصر: palace
صوت: voice
لأخيك: for your brother
بيضاء: white
أعطيت: was given
سنكون: we will be
تناسب: suits
الهاربين: fugitives
محارب: warrior
فهم: understanding
بغداد: baghdad
وأسمع: and i hear
يحدث؟: happen or occur?
سيدي؟: sir?
بعيدة؟: far?
محبة: love
الخزينة: treasury
نظام: system
هو؟: he is?
للصيد: for fishing
يحدث: happen or occur
المسلمين: muslims
سيدي،: sir,
الق: acces
اجلس،: sit,
هدوء: calm
أخذتني: she took me
لتعبئة: to mobilize
الى: to me
القسطنطينية: constantinople
علينا: we
أيضًا: also
صعبة: difficult
غدا: tomorrow
اعتن: take care
ترى: see
بخير: fine
تجنيدهم: recruited
كتم: mute
يد: hand
المقر: headquarters
العظيم،: great,
تحقق: check
أجزاء: parts
يا: oh
بيننا: between us
،: ,
هذا؟: this?
الحالة: case
إلانورا: elanora
أرسلتهم: i sent them
يسمى: he is called
وعائلته: and his family
هذا،: this,
اللغة: the language
بشرة: skin
اختطفوها: they kidnapped her
دعني: let me
إنها: it
نعم،: yeah,
أعط: give
الرجل: the man
عيني: eyes
عام: public
وإلا: otherwise
درجة: degree
نقاتل: we fight
والانتعاش: and recovery
هربوا: they fled
قلت: i said
كلمة: a word
حسناً: ok
وجدت: have found
الضلع: the rib
يحتاجون: they need
كانت: she was
جئت: i came
يهاجموننا: they attack us
للحفاظ: to maintain
حرا: free
قلق: anxiety
مباشرة: directly
كيف: how do
توقفت: i stopped
السن: age
يهربون: they run away
نذهب: we go
أولاً: firstly
وحده: alone
المجاعة: famine
توقعاتك: your expectations
انتظر: wait
جلبنا: we brought
الأسرى؟: the prisoners?
السلجوق: seljuk
الحرس: the guard
للغاية: extremely
يعطيه: give him
البصرة: basra
الاضطراب: turbulence
حسنا: ok
ولا: nor
جيدا،: well,
حسنا،: ok,
أوراق: leaves
والخانات: and khans
تعرف: know
بشرف: with honor
والدنا: our father
سيكونون: they will be
استفزاز: provocation
اشتريته: i bought it
قصور: failure
إذن: ear
لإنفاق: to spend
طريقة: method
السلاجقة: the seljuks
بأكملها: whole
دمك: your blood
أتيحت: made available
قدمت: submitted
سنرى،: we'll see,
مصاب: injured
كنت: i was
انتظرت: i waited
سمعنا: we heard
ضحيتك: your victim
الذهاب: going
الباسلة: valiant
العالم: the world
عن: about
تيتوس: titus
لحسن: for good
افعلها: do it
أقتلك: i kill you
سأشتريها: i'll buy it
قائمة؟: list?
المسيحي: christian
نظرة: a look
كاي: kay
وشاهزاد: and shahzad
عد: counting
قدر: saucepan
جديد: new
تخفيف: mitigation
ضرائبهم: their taxes
أعمى: blind
بصحة: healthy
يتضور: is attending
بك: your
يأتي: come
أخيك: your brother
يتنفس: breathes
الاعتناء: look after
نجحنا: we succeeded
يوجد: exist
بهم: their
استخدامها: use it
الذي: which
فسنحكم: we will judge
آخر: else
تعال: come
انتهت: expired
اساعدك،: i help you,
نكتشف: we discover
أمانوس: amanos
الدولة: country
البابا: the pope
خريطة: a map
تخاف: afraid
ينبغي: should
قويا: strong
فرصة: chance
أهلا: welcome
الجحيم،: hell,
هذا: this
لقتله: to kill him
الجحيم: hell
الطريقة: way
الوقوف: stand up
بالآلاف: in the thousands
مصير: fate
تقتل: kill
اصمت،: shut up,
تضربنا: beat us
هنا: here
دفع: pay
جيدة: good
يخبرنا: tell us
ذاهبون: are going
المزيد: more
رخيصة: cheap
سيدها: her master
سوف: will
سوق: market
البلوط: oak
يتحد: unites
مقابل: opposite
يقتل: kill
أكثر: more
إنهم: that they
نعمان: noman
القدس: jerusalem
غزانفر؟: ghazanfar?
قلعة: castle
فينيسيا: venice
فأود: i would
نبيلة: noble
واستسلم: he surrendered
نجد: we find
دماء: blood
أصبح: had become
فيه: in it
تعفيني: my exemption
يساعد: helps
كرمتنا: our generosity
مهتمين: interested
اليونانية: greek
لديها: she has
الكرنفال: carnival
التركمانية: turkmen
هنا،: here,
الأوروبيين: europeans
كان: it was
الدم: the blood
بسرعة: quickly
أراها: see her
تيتوس؟: titus?
تقل: less
ونشأنا: and we grew up
الحظ: luck
فهو: it is
الغداء؟: the lunch?
الصليبيون؟: the crusaders?
الحياة: life
عامة: general
أليس: alice
بأنفسنا: by ourselves
المسألة: matter
عليها: on her
عندما: when
تبدو: look
إضعاف: double
مونتين: montaigne
قوياً: strong
أخذك: he took you
سندفع: we will pay
فقدناه: we lost it
لكي: in order to
الامتناع: refrain
لكن: but
ذروة: climax
تتحرر: free
بي: b.
جزيلا،: so much,
تقول: says
مجموعة: collection
إذا: if
سيف: sword
سقي: quench
تكون: be
ألم: pain
الطعام: the food
القتال: fighting
كاراتويغار: karatwigar
فقط: just
صليبية: crusade
أرتوغرول: artogrol
تطورات: developments
الجيش: army
أوجوز: oguz
طريق: way
ننتظر: we wait
ضد: against
قبيلة: tribe
المرتجع: discards
أننا: that we
بهذه: by this
شاهزاديس: shahzadis
ونحن: and we
أمينة: honest
إن: that
فستكون: it will be
البهلوانات: tumblers
به،: with it,
أسرنا: our families
عليهم: on them
رجل: a leg
يرام: okay
ابنتي: my daughter
السجناء: prisoners
afsin: afsin
تدفع: you pay
عناء: trouble
الله: allah
للشباب: for young people
يأخذوننا: they take us
ذوق: taste
والسلام: and peace
ضرائبها؟: their taxes?
تود: todd
الهدايا: gifts
متوفراً: available
لقبيلة: to the tribe
دوجان: dogan
الجميع: everybody
والشخصيات: and characters
خذيه: take it
خضراء: green
الواضح: obviously
للضرر: for damage
حسن،: hassan,
حيث: where
الأيوبي: ayoubi
المتوسط: average
فخرك: your pride
ليكونوا: to be
ما: what
أولادي: my children
المكان: place
صد: bodice
خذها،: take it,
آغا: aغاa
قداسة: holiness
بهم؟: their?
مع: with
سريعة: a quick
الأخ: the brother
تذهب؟،: you go ?,
والخروج: and get out
ترجمة: translation
الجديدة: new
آوى: accommodate
الخاصة: own
ملاديز: maldives
الفتاة: the girl
ضابط: officer
أحضروها: bring it
ثمن: price
يهدأ: calms down
مني: mona
الطريق: the path
الخلود: eternity
طلبت: requested
لرؤيتك: to see you
غاضب: angry
عدد: number
لشخص: for a person
يستعدون: they are preparing
فصل: season
القائد: leader
لحظة: moment
العبودية: slavery
لهم: for them
أستطيع: i can
نريق: fire
سيئة: bad
الموت: the death
مهمتنا: our mission
مكان: a place
قبيلتك: your tribe
سيبيعوننا: they will sell us
افعلها،: do it,
tribe: tribe
متبقية: remaining
علي: ali
الشائعات: rumors
قونية: konya
على: on
قيد: restriction
الشتاء: winter
صلاح: salah
تفعل: are doing
مدركين: are aware
العضات: bites
موجود: existing
العمل؟: the work?
الحمد: praise
استيقظ: get up
أخي: brother
يكون: is being
النار: fire
أخي؟: brother?
الصليبيين: crusaders
قائد: leader
رائحة: smell
كانوا: they were
حقيقي: real
تأخرت: delayed
الأولى: first
أين: where
المجاعة؟: famine?
يدفعون: they pay
العبودية؟: slavery?
للثروات: for riches
خطة: plan
يأخذك: takes you
خذ: take
عليكم: on you
جدًا: very
هذه: this is
دمشق: damascus
أيد: supported
لكان: for was
قلته: you said
يواجه: faces
الحدود: the border
خيمة: tent
الأفضل: best
تتعرض: exposed
قطعة: plot
الجيد،: good,
لا،: no,
الوقت: time
نظامنا: our system
يترددون: they hesitate
يعود: returns
الصليبي: crusader
العالم؟: the world?
المغولي: the mongols
تضع: put
والمطاردة: and chase
حان: it's about
شكرا: thanks
جبال: mountains
تصوير: take photo
عزيزي: my dear
أصم: deaf
رجلك: your man
قائدهم: their leader
لا: no
ستبقى: will remain
أخت: sister
ترتاح: rest
ربما: maybe
تشعر: feel
رفض: refusal
لي: mine
لو: lou
لن: will not
له: for him
لم: did not
يديك: your hands
لك: is yours
واحصل: and get
مقر: headquarters
واحد: one
مظلمة: dark
قليلا،: a little,
الحشمة: decency
سنمتلك: we will have
حاجة: need
الراحة: comforts
جميع: all
سعيدة: happy
ضبط: adjust
تحافظ: maintains
أنتما: you
40: 40
سوزان: susan
أحضرت: i brought
عزرائيل: azrael
لكن،: but,
تم: done
اعرف: i know
يسقط: drops
فعلنا: we did
مثلك: same to you
للقيام: to do
أشفق: pity
ولكن: but
العودة: go back
للآخرين: to others
في: at
ابنتك: your daughter
حدث: event
عمل: action
تعامل: deal
بالتضور: to attend
وهي: which
وهو: and he
أول: first
نسمح: we allow
أخبرنا: tell us
واجب: duty
معك: with you
حدث؟: event?
المنتج: the product
البابوية: the papacy
وقف،: stood up,
بقايا: remains
نسيت؟: forgot?
إذننا: our permission
سفينة: a ship
جنب: side
تلك: that
turgut؟: turgut?
ضربه: a hit
2000: 2000
الخلاف: disagreement
اين: where
أعضاء: members
متجر: a store
للطريق: for the road
لكمين: to ambush
