kaçmaya: escape
allame: allame
yükselecek: will rise
baksın: you look
müsaadeniz: your permission
komutanın: the commander
komutanım: my commander
ararsın: you call
müsaadenin: permissible
babandan: from father
dahildir: included
yemeye: eat
göçtüğümüzde: when migration
hizmetleri: services
aklınıza: your mind
zannettin: you think
indirin: download
konuşup: talk
tanışabilirsem: i can meet
saplanmış: bogged
kabilesinde: the tribe
yükün: load
tenini: the flesh
sokuldum: i introduced
kontrolünü: control
çiğnerseniz: if you chew
belasından: from trouble
altındaki: below
deli: mad
kızınla: with daughter
alpiyle: with mountaineering
sesuyan: sound fits
rezalet: disgrace
titriyorsan: if you trembling
akıllıca: wisely
erkekallah: erkekallah
neyse: anyways
sınırlarımıza: our borders
idare: administration
anlaşma: contract
şom: solid
öğreneceğim: i will learn
kalıyor: staying
iradesine: will the
yüksek: high
iradesini: willpower
yardımcısı: help
salona: hall
çadırınıza: your tent
giremezsiniz: you can not enter
keseceğim: i will cut
içindeydi: it was to
öğreneceğiz: we will learn
hoş: pleasant
başta: first
umrunda: cares
fışkıracak: to gush
sülün: pheasant
hepimiz: we all
dahi: even
kapılır: doors
günün: your day
vuracaksın: you're gonna shoot
daha: more
zikir: remembrance of Allah
tabak: plate
sultan'ın: the sultan
gitmeyi: to go
boştu: it was empty
çık: exit
aldığın: you get
görmeden: blindly
gitmek: go
gitmem: i dont go
gitmen: do not go
günlerine: days to
akıntıya: upstream
alabilirim: i get
ortağıyız: partner
gitmez: do not go
aylardır: for months
günlerini: birthdays
Önlem: prevention
müthiş: terrific
tahammül: tolerance
ahalinin: the population
soğuğunda: cold
yapmalıydı: should have done
döşeğindeki: on deathbed
taşıdığın: you carry
hepiniz: all of you
geçeceğimi: i now
konuşun: talk to
tamamladı: completed
gittiğim: i went
düşüneceğiz: we consider
söylemeliyim: i must say
bağdat'tan: from baghdad
kefereleri: unbelievers are
hazırlanmak: prepare
kabilemiz: our tribe
yollara: cause
yolculuk: trip
töremizi: honor our
kabilemin: my tribe
börü'yü: pipe
sonucunu: result
eskiden: formerly
temas: contact
mazlumlar: oppressed
gazanfer: gazanfer is
kafeste: in a cage
Çayı'nın: brook
kayı'nın: the boat
dirliği: ballad
cirit: javelin
işimiz: our business
almamı: take my
keserim: i cut
endişeleniyorum: i'm worried
şart: must
taşırız: we move
sorunum: my problem
sorunun: the problem
endülüs'ten: the andalusian
kalana: the remaining
sanki: if
yapalım: let's do
misiniz: are you
giderler: expenses
kızlarım: my daughter
başaramayacaksınız: you will not succeed
pirimiz: our pyridyl
köpek: dog
başarır: success
birbirinden: from each other
geçip: through
mallarımızı: our goods
geçit: passage
öderiz: we pay
ateş: fire
sahipler: owners
gizlenip: hid
duruma: condition
paylaşan: share
hatırlatmak: remind
haydır: is alife
Çölleri: deserts
bildireceğim: i will tell
bulmazsınız: you will not find
durumu: status
verilecek: will be
örelim: i weave
yüze: to face
kurtuluşun: the salvation
ormandaki: in the forest
yıldızlı: starry
bundan: from this
inan: believe
sayar: counter
günaydın: good morning
büyütür: enlarge
temizlesin: cleanse
kitaptan: from the book
derdest: pending
hazır: ready
endamınla: with endamı
o'na: him
yapmayı: making
haşa: housing
eritmeyi: melting
girmiyor: does not enter
uçur: blow
uçup: fly
sandığın: the polls
etmeyi: do not
kesmiş: he cut
masraflarından: the costs
yoklayıver: yoklayıv is
katleden: massacring
etmeye: do not
adında: named
yüzü: face
toplanıyor: collecting
kilimhanede: in kilimhane
allah: god
düşmüş: fallen
çürütürdü: he refuted
haber: news
esirler: prisoners
getirmesi: bring
titus’la: titus'l to
halletmemiz: we handle
değiliz: we are not
birbirinize: to each other
yürüyebilseydin: you were yürüyebils
içerideydi: it was in
birbirinizi: another you
varken: while
pusatlı: the pusatl
giyindin: you dressed
yemedin: you eat
büyüdü: enlarge
savaşçılarından: the warrior
kuraklıkta: drought
bunları: these
üşüyen: feeling cold
aleyküm: aleyküm
mademki: whereby
okuyabilir: you can read
şimdikinden: the current
dövdüğün: you beat
pirim: pirim
katılacaksın: you will join
uyardım: i warned
getirirler: they return
kervanımda: my caravan
hazırlan: prepared
kurtardı: saved
erlerin: the sooner
söyleyecek: will say
çünkü: because
ata: ancestor
kullanmazlar: do not use
sahi: actually
tanrı'ya: god
Şah'ımızın: our şah'ı
beraberliğinize: your togetherness
rahime: rahime
yıkadın: you wash
nefsimiz: our souls
kayı: registration of
adamsınız: the man
elma: apple
planlarım: i planned
kazanırsın: you win
gündoğdu'nun: the gündoğdu'nun
karatoygar: karatoygar
olmadan: without
oldu: it was
kattalar: they katti
yokluğunda: in the absence of
kişner: snigger is
kardeşlerimiz: our brothers
şeytan: satan
bıraktı: he left
papalıktan: the papacy
varı: there
birazdan: soon
istersen: if you want
yargılanıyor: on trial
tükenir: exhaustible
devam: continuation
yenge: aunt
esselamü: my esselamu
kütüğe: billet
hayt: hayter
yağız: swarthy
etkiyi: effect
bıçaklı: bladed
reddediyorum: i refuse to
endişeli: worried
kardeşlerinin: brothers
bıraksın: you left
olsaydı: had
bunlara: to these
sallayarak: shaking
götür: take
domuzun: the pig
anlattıkları: they tell
töre: custom
kıvamını: consistency
kayi: kai
torunuyum: my grandson
kaya: rock
çantasından: the bag
karargahıma: my hq
boylarının: the size
bulacaksın: you will find
tanrı'yı: god
duydun: you heard
duydum: i heard
duyduk: we heard
olacak: it will be
sevdi: loved
buramda: me here
yüreğiniz: your heart
elbette: of course
bunların: these
nil’den: from nil
dönüştürmeni: convert
destanlarında: epics
hatayı: failure
tepesi'nde: the hill is
kütüğü: index
emmisinden: the uncle
alması: take
arkanı: the rear
kaldığını: that remains
vazifesi: duty
şahidim: my witness
duyulursa: if needed
cenazeleri: funerals
yendin: you beat
söndürecek: will put
işaret: mark
rica: request
Çabuk: quickly
yapamazdın: you can not
hırsını: ambition
sıkı: tight
konuşturdu: konuşturdu
görmelerini: to see
mühim: important
tamamı: all
sıkışmış: jammed
evet: yes
yakaladın: caught
bırakmayacaklar: they will not leave
kır: dirt
ayrıca: also
kız: girl
söylemediler: they did not tell
şeylere: things to
yüzümü: my face
hatırlıyorum: i remember
yüreğini: his heart
dağıt: deal
ersiz: invalid
deseni: pattern
templars: templars
kaçırdın: you missed
desene: pattern
Öldürün: kill
adamlarınıza: your man
soysuzun: the ignoble
rüyadayım: i am a dreamer
beslemelisin: you should feed
çiğneyip: chew
ayrılacaksın: you will be leaving
başkentlere: the capital
hatırlatırım: i remind
uyanık: awake
girmediler: they did not
deveye: camel
kuyudaki: in the well
çadırlarını: their tents
akıyor: flows
sevdiniz: you like
gözler: eyes
düşerek: down
kervanımızdan: our caravan
uğraşacağız: we will deal
yeterince: enough
asker: soldier
kurtulamaz: can not escape
bulmamız: finding
afiyet: appetite
çekelim: let's take
bulmalısın: you have to find
budala: fool
niye: why
ayağa: foot
hırsına: ambition to
bisol'den: from bisol
delisini: the crazy
zaten: already
sıkan: frequently
doyar: is saturated
kollarını: arms
obası'ndasınız: obası'nd here
eşlik: accompaniment
sırtında: horseback
döndü: returned
diriliş: resurrection
gitmeye: to go
olmuyor: is not
laneti: curse
sebep: reason
bulmayı: finding
yanınızda: with you
kış: winter
yalan: lie
oradasın: get there
koşamazlar: can not run on
yapamazsın: you can not
affetsin: forgive
baybora'yı: the baybora
kadarmış: so much
oraya: to there
tapınakçıların: the templars
dediğin: you say
dediğim: i also
vergisini: taxes
sevdiği: love
olmasın: whether
göreceğim: i will see
satın: buy
gireceğiz: will enter
dinlenin: relax
döndüler: they returned
çıkar: interest
toparlaman: the roundup
adaletidir: justice is
yapma: making
tavsiye: advice
öğütüldüğü: it is ground
kibirliyim: 'm arrogant
geleceği: the future
”: &quot;
mızrağıyla: with the spear
düşsem: i duss
kalbimde: my heart
dirliğini: the provisions are kept
selahaddin: saladin
neredeyiz: where we are
topu: ball
biçarelerin: the wretched
sevdiğine: he loved
topladık: we collect
İyisin: you're good
topladım: i gather
yorgunum: i'm tired
elveda: goodbye
bayrak: flag
kalmış: i have stayed
ettiler: they
hallettik: we care
üyesi: member of
koşun: run
hayat: life
görüyor: sees
halimelerle: state malarla
savaşır: fights
izadora'ya: isadora to
bıraktılar: they left
iyileşsin: you heal
denekleriniz: your subject
savaşım: fight
galiba: probably
gelmezdi: would not come
hah: hah
ovalara: to the plains
hak: right
han: inn
ertuğrul’a: ertuðrul to
haa: ha
hay: hay
zorluğa: difficulty
konuşmalı: should talk
bazı: some
yapraklarıyla: leaves with
ertuğrul’u: ertuðrul of
muştuyu: he is
davacı: plaintiff
kumandanlarıyla: their commander
edebiliriz: we can
nesidir: what is
müstakbel: prospective
kör: blind
gülünç: funny
sanmıyorum: i do not think so
bırakırsın: you leave
edebilirim: i can
uyku: sleep
söyleyeceksin: you're gonna tell
belediye: municipality
borçlusun: you owe
otağında: in the tent
rüyanda: in the dream
söylediklerinden: they say
edebileceğim: i can
oldular: they were
salladığın: you shake
ola: it is
oluyorum: i'm
geçtiğinde: when now
haberlerimiz: our news
oğlum”: son&quot;
güzelliğinden: from beauty
kalabileceğimiz: we can stay
zalime: cruel
çekinme: wince
Şükürler: thank god
bize: to us
kıydıklarını: they chop
bizi: us
karşılığında: in return
iyileşme: improvement
kaçmak: escape
tutmayı: retention
camilerine: the mosque
sembollerini: symbols
uygundur: suitable
şerefine: in honor of
İş: business
yıkanabilir: washable
şerefini: honor the
kudretli: mighty
öğrendi: he learned
müttefik: allied
dinlenelim: i rest a
kuzularım: i lambs
hikaye: story
hâlini: still the
koruyan: protecting
aklı: mentally
hâline: into
o: he
yenmeyi: defeat
yoktu: did not have
kederlisin: you're heartsick
sorgulayan: questioning
tırnağınla: with fingernail
borçluyum: i owe
son: last
sor: sir
girebilirsiniz: you can enter
dostlarını: his friends
adaletin: of justice
etmeliyiz: we have
istemem: i do not want
dönmeden: returning
joseph: joseph
kollarında: in arms
ayaklanma: riot
karıştırmadın: you mix
menzilimiz: our in range
akşamki: evening
böğürme: moo
sokacaksın: you're gonna get
vermenin: do not
yaptığını: do that
fedakâr: devoted
baci: sister
verdi: gave
kendileri: themselves
gelmeyecek: will not come
sorun: problem
olacakmış: going to be
kayın'ın: the beech
farkındasın: you realize
İç: internal
aklında: in mind
tugrul’a: tugrul to
hanımız: our h
saygı: respect
devletimin: my government
köpeğe: dogs
boyunca: throughout
köpeği: dog
zindanın: the dungeon
ödemesini: pay
sonucun: the results
obam: i obama
oban: obama's
tükenmek: run out
sokacağız: sokacağız
merhaba: hello there
tanırım: i know
ifadesiydi: statement was
neşeli: cheerful
tanırız: we recognize
Şövalyelerine: the knights
ayran: buttermilk
kirpik: eyelash
kargalarla: with crows
tanesini: them the
düşünmeyecek: thinking that
pusu: ambush
İt: it
sendin: you're the one
asla: never
sevilen: popular
İn: of
yakalayacağım: i will catch
olduğunuzu: be you
ayrılacağız: we leave
zanaatkarım: i artisans
endişeni: concerned about the
hastalanacaksın: you're gonna get sick
cezasını: sentence
devleti: state
yanasın: since you
ver: give
yeri: place
servetini: wealth
tarafından: by
yere: place
ayrılma: separation
işitmez: not hear
belleyecek: to memory
düşecek: will fall
hatırlamayın: remember
düşmandan: the enemy
fakı: the fake
konusunda: about
bozkır: steppe
köklerimin: my roots
yansın: half of
uyuyamadım: i could not sleep
elenora: elenore
muhafızların: of the guard
değildin: you did not
suçluları: offenders
orduya: army
hayatlarını: their lives
değildir: is not
yapsınlar: they do
orduyu: army
katilinin: the killer
noktaları: points
yapılacak: to do
soluğa: breath to
titriyorsunuz: you shaking
oturamaz: can not sit
suçlular: criminals
karıştırmasın: you're mixing
yapacağını: would do
işbirlikçileri: collaborators
uyanmak: wake up
kasabaları: towns
âlemin: the worlds
zindanlarında: in the dungeon
gündeki: on the day
anlamı: meaning
turgut: turgut
kaçmamaları: they flee
ayyuka: ayyuka to
kargalı: kargalı
ordu: army
ötesi: beyond
göçten: from migration
efendim: sir
geçtik: we now
Şövalye: knight
geçtim: i passed
geçtin: you now
mıyım: am i
olduğuna: that
krallığında: in the kingdom
öncesi: pre
bulmuşsunuz: you found
öyle: so
çekenler: wreckers
olduğunu: that
kardeşdik: kardeşdik
noktasını: point
havlayan: barking
tutamazsın: you can not
oturur: sits
diline: language
olabilir: can
börü: pipe
kalesi: stronghold
kendisini: himself
kandili: kandili
harcamaya: spending
kendisine: to herself
başlayacaklar: will begin
birimiz: one of us
salın: released
zevkli: tasteful
varlık: presence
bitirmeden: before finishing
efendi: master
soracaktım: going to ask
benden: from me
yaşayacaksın: you're gonna live
yanlarına: their side
kalmayalım: let's not
konuşmaktan: to talk
odun: wood
yermiş: places have
hazırlamalıyız: we have to prepare
halkımıza: our people
gariplerim: my weird
soluyacağım: i'm left
kızılcık: cranberry
adaletmiş: that justice
şeytanın: the devil
beklenen: expected
gezginim: my browser
desek: to say
yapacaksın: you do
askısını: suspended
odur: it is
sesleri: sounds
süzüp: by filtering
kurdoğlu;: kurdoglu;
görüyorum: i see
körelteceksek: if we blunting
şikâyetçi: complainant
dolduran: fill
pazarına: market
çevrili: surrounded
eski: old
İstediğiniz: you want
mektup: letter
yüce: sublime
tiran: tyrant
herşeyi: everything
duyacağız: we heard
selcan’da: in selcan
daima: always
imtihanın: the test
çizgiyi: line
İyileşmesi: healing
düne: yesterday
ettiğim: i've
ettiğin: you're
atam: my ancestors
atan: assign
görmekle: seeing
kötü: bad
diyecekler: they will say:
ana'nın: your mothers
gittiğiniz: you go
alsın: you get
beyazdı: it was white
anlayacağı: will understand
topraklarından: their land
su: water
toplarız: we collect
bırakırsınız: you leave
yanımızı: y our
askerlerini: soldiers
güvendeyiz: we're safe
düşmüyor: does not fall
yapabileceğimiz: we can do
başkasını: someone else
baybora: baybora
yakup: jacob
Öğrenmiş: learned
suçlanır: accused
mevkiye: position to
parçan: part
kont: count
konu: subject
pekmez: molasses
birliğini: unity
biliyorsun: you know
irinini: the pus
yürürler: they walk
gazap: wrath
İsteriz: we want
götürme: to bring
uykusuz: sleepless
gâvurların: the unbeliever
bitmiyor: do not stop
yapansın: you're engaged
kaynağıdır: source is
toygar’a: a lark
körükler: blowers
değse: worth all the
mektubu: letter
Özellikle: especially
bizimle: with us
ödesin: you pay
tuhaf: strange
rağmen: despite
düşeceklermiş: they'il fall
meyvesi: fruit
mektuba: letters to
midesinden: from stomach
türlü: various
değilsiniz: you do not
beyin: brain
felaketler: disasters
yıkmaya: to demolish
beyim: lord
hayatımda: in my life
isyan: revolt
ortalık: mess
karatoygar'a: karatoygar to
denizlerin: seas
ellerine: to your hands
ellerini: your hands
beyini: the brain
düşeni: falling
alacak: credit
üstüme: to top
oynadı: played
gömülecek: be buried
muştumuzu: had our
'nin: 's
uyuyan: sleeping
başlığı: head
ismini: your name
birleştirdi: combined
böceği: beetle
başsağlığı: condolence
aramızda: in our midst
bâki: eternal
kutsanmış: sanctified
eğittim: i trained
ertelenir: postponed
harika: great
hiçbirimizin: none of us
varsa: if
annesinin: his mother
atacağım: i will throw
kelepir: bargain
insanlara: to people
Şah’ın: hawk
yolumuza: our way
çalışıyorsunuz: you are trying
sağ: right
Şehri'ne: city of
borcunu: the debt
topunu: trackball
bilmiyordu: he did not know
ona: him
almak: receive
bulanıklaştıran: that blur
kavuştuk: we have put
haktır: is right
boğulduğunu: drowned
konuşuyoruz: we are talking
almaz: it does not take
onu: himherit
kalalım: let's stay
görevi: task
2: 2nd
çakıl: gravel
cesarete: courage
cesareti: courage
tamamlayalım: let's complete
yardıma: help
göreve: task
geze: visit to
bebek: baby
yerleştirilmeden: being placed
allahümme: allahümme
etmiş: meat
takalım: my orange fruit
torunlarınızla: your grandchildren
verebilir: can give
başkasına: someone else
kefereye: unbelievers to
bucaksız: the expanse
korkmana: do not be afraid to
yüzlerce: hundreds of
tarafta: on the side
biteceğini: will end
demir'in: the iron
bulmazsak: we find
dedikten: you also
saf: pure
işlerim: my works
kızla: girl
kızından: the girl
vahşi: wild
yapmadan: without
İşin: ray
sözcü: spokesman
avlanacak: will hunt
edersiniz: will you
zor: hard
insanları: people
yöredeki: in the region
yollayıp: send out
türkmen: turkoman
tutabilirse&quot;: can hold &quot;
düzey: level
taşıdım: i moved
tanrı'dandır: are of god
büyüttük: we grew
yarattı: created
düzen: order
mahkemede: in court
kaynanan: the motherinlaw
acımla: with pain
göndereceğim: i will send
kılıç: sword
akçeye: reserves to
hükmet: judge
içimizde: inside us
etseydin: if you'd
izniyle: courtesy
Şuncağızın: the şuncağız
şaşıracaksınız: you will be surprised
cesaretimi: courage
yeğen: nephew
yaparsın: you do
çatır: roof
açların: open the
eylesin: eylesin
gideceğini: would go
ana'ya: home to
haksızlığa: injustice
vardır: has
zekân: intelligence
söyleseydin: if you told
bebenin: beben
yaraya: wound
İmkânımız: our opportunity
güzelce: nicely
rahatlayacağımı: i relax
kaçırdığı: missed the
birliğimin: my unit
ölmesi: death
hayvanlarımızın: our animals
Şimdilik: for now
parçalayıp: shred
iftiralar: slander
rahatlarız: we relax
saldırmaya: attack
kaybederiz: we lose
istersin: you want
casuslarını: spy
ahmak: idiot
sevdiklerini: they love
Çektiğimiz: we czech
rezzak: rezzak
edeceğiz: we will
vermeyeceğim: i will not
yanından: over
görmeyeceksin: you will not see
istiyorsan: if you want
durma: stop
kaybettiler: they lost
bilmezsem: i do not know
yürüdün: execute
vermeyeceğiz: we will not
yedir: feeding
düştün: you fall
bahsettik: we talked about
süleyman’ın: solomon
namusunuzu: honor your
düşündüğümü: i think
cin: china
ileri: next
kurasın: you set up
töredir: ceremony is
gelini: bride
zamanlarımızda: our time
beceriksizliği: incompetence
pelerinimi: my cloak
birliğe: unity
öfkemi: my anger
birliği: unity
eyerleyip: eyerleyip
susup: shut up
düğünün: the wedding
getirdikleri: they brought
kaçması: dodge
inatçılığı: stubbornness
sadakat: loyalty
ağzımızda: our mouth
gitmene: go to
hatunlar: hatunlar
göremiyoruz: we do not see
yedirdim: i fed
yarattın: you created
topraklarında: in the territory
ordusunun: army
sevineceksin: will you glad
göremiyorum: i can not see
katkım: my contribution
mani: slashing
müjdeyle: müjdeyl to
liderlik: leadership
yaylasında: in the highlands
yolculuğunda: the journey
takılan: installed
yakanda: the burning
kurdum: i installed
geçici: temporary
konya: konya
erdem: virtue
duralım: let's stop
mektuplara: letters to
İznimiz: our permission
omuzlarında: their shoulders
emniyeti: safety
güzelliğinle: with beauty
meydana: occur
anlaşacağız: we agreed
kaçışını: escape
eğilip: bent
lanet: curse
geleceğiz: we will come
değildim: i was not
enine: transverse
korkuyordun: you afraid
birlikte: together
geleceğim: my future
konforlu: comfortable
bakarım: i look
karşılaşır: encounters
yapabileceğim: i can do
koyduk: we put
koydum: i put
koydun: you put
yiğit'le: yiğit'l to
düştüğüm: i fell
pusludur: is hazy
yaşlı: old
önlerinde: in front
aklındaki: in mind
koydu: laid
hayatım: sweetheart
etme: to
başlatmış: launched
Şerefinizi: honor your
tatlı: dessert
değerince: amounts unless
musibetleri: evils
bağdat: baghdad
taşın: move
attığın: you take
koyuluruz: we put
utanma: shame
emrin: the order
makama: authority
kumaşlar: fabrics
ali'den: ali'den
birinde: in one
Öfken: anger
tasalanma: worry about the
sözün: the promise
dirlik: dirlik
elini: your hand
aşına: familiar
dördü: four
eline: hands
gelmeden: arriving
sefer: expedition
şey: thing
ediyorsun: you're
kumaşlarını: the fabric
sonsuza: infinity
şer: evil
tıpkı: just as
toparlayıp: pack up
mutsuz: unhappy
kuruyorsunuz: you make
evlatlarımızın: our sons
diyorsam: i say
şövalyenin: knight
ilgili: about
neyin: what
kalbime: my heart
soracağına: will ask
taylarımızın: our foals
kalbimi: my heart
gelmişsiniz: you come
İçlerinde: among them
kısraktır: and mares
beklesinler: let's wait
parlak: bright
mühürlendi: sealed
Şehzadelerle: with prince
başımız: our head
başımın: my head
allah'tan: from god
İşimiz: our business
dizlerine: knees
duyuyor: hears
hıh: hýh
konuklar: guests
alçaklar: lows
alpsungur: alpsung is
diyar: land
avcının: the hunter
kimseyi: anyone
görecek: will see
darp: assault
azrael'in: the azrael
getirip: bring
getirir: brings
sandın: you think
getirin: bring the
tohumları: seeds
anlaşmaya: deal
tutturmak: fasten
çelik: steel
dara: tare
katilleriyle: with killer
kafirleri: the unbelievers
iyileşmesi: healing
kafirlere: infidels
utancımız: our shame
tanıyorsun: you know
öyleydik: we had was
onlarla: with them
çekmeyin: pull
alan: area
otağımıza: our otag
hazırlıklı: prepared
sanıyorsun: you thought you
iyileşmesini: healing
peşimde: after me
hatır: sake
grup: group
İlk: first
korkusuyla: fear
enfekte: infected
önümüzde: ahead
isterdi: he would have liked
başaramadık: we could
attım: i threw
tutuyor: holding
dolaşarak: touring
öyleyse: then
görüldük: we have seen
Çeliğe: celik
sürece: as long as
aş: overcome
haberci: reporter
hareket: movement
sakinleştirmek: smooth
lağım: sewer
sakladığının: that stores
veriyor: giving
bırakmayalım: bırakmayalım
söylemeden: without telling
dinleneceğiz: we shall rest
ejderhanın: the dragon
bunlarda: in these
meğer: meğer
araştırmaya: to research
şahittir: it is witness
ertuğrul'da: in ertuðrul
kuran: koran
tapınakçılar: templars are
kaderi: fate
saldırın: attack
arkasında: behind
almasını: take
girerler: they enter
ilişki: relationship
olmayın: do not be
bilemedim: i did not know
aç: hungry
yaşadık: we lived
yaşadım: i've had
zordu: it was difficult
rüzgarlara: winds
bırakmak: to leave
ferahlığı: freshness
toplamak: collect
hedeflerinize: your goals
hep: always
her: every
bozuk: broken
hey: hey
yurdumuza: our country
verilir: given
hem: and
kararımı: my decision
cezalandırılırdı: he was punished
kapılma: the doors
kurtuluşu: salvation
olduğu: that
yaya: pedestrian
almalıyız: we need to get
cinayet: murder
karargahın: headquarters
yazık: pity
sarmadan: from winding,
tacirdir: and traffickers
durdurmamız: our stop
kurtuluşa: salvation
kumandan: commander
yapan: who
çıkma: emergence
hayvanlarım: my animals
yapar: makes
ihtiyar: old
itaat: obedience
yardımınızla: with your help
aa: aa
sürüsünün: the herd
ohh: ohh
af: amnesty
ah: ah
ak: white
düzelecek: it will be fine
taptığı: worshiped by
an: moment
ar: ar
at: horse
av: hunting
dönemeyiz: we periods
az: little
sebepten: reason
bölükbaşı: bölükbaşı
gözükmeyeyim: i look
hallice: rather vague
olduğun: you are
acı: pain
başları: heads
arzunuz: your desire
itirazı: appeal
şaşırırdı: he was surprised
âlâ: superb
ezseydin: you were ezs
komşularından: their neighbors
annen: mother
annem: my mother
atlara: horses
saçtan: the hair
edemem: i can not
ittifak: alliance
sözü: mentioned
anlayamadık: we could not understand
dolaşıyorlar: they are walking
cesedi: corpse
düşünmeyin: thinking
bağışla: donations
öttürüyor: traversed the
şahidimdir: my witness
nefesi: breath
adam: man
İnsanı: human
gülme: laugh
kafandan: the head
döndüğümüz: we return
gelemeyecek: can not come
yıldönümü: anniversary
akçakoca: akçakoca
yakışır: worthy
gök: sky
deneyimli: experienced
göm: buried
kaplayacak: to cover
kızmanın: do not be angry
göz: eye
gör: see
ta: t
sardık: we wrap
yabancı: foreign
estağfurullah: do not mention it
kutlamak: celebrate
dönecekler: will return
kırılırsın: you break
baybora'nın: the baybora
hayatımız: our life
kontrol: control
dinleyemem: i can not listen
fakih’e: jurists to
gezerek: scrolls
vefat: decease
konuşmalar: speeches
sana: you
hatun'lu: the hatun'l
viziyerimizin: our viziyeri
olacağınızı: com'on
taşıyın: move
başlayacağız: i'll start
planı: plan
peşine: advance to
hazırlık: preparation
sekiz: eight
evleneceğimizi: going to marry
göç: migration
zalimler: wrongdoing
bağlasaydınız: if you tied
yanda: in addition
yayılmışsınız: you spread
yaranızı: your wounds
kaldıran: the lift
halifenin: the caliph
vatanımıza: our homeland
kartallı: kartallı
ölürse: dies
alkışla: applauded
torbalar: bags
akacaklar: will flow
düşünüyor: think
takmış: wearing
annene: to your mother
denizleri: seas
aslanlığınızı: your aslanlığı
kendime: to myself
yolumuzdan: our way
cesurca: bravely
çocuklarına: children
başarılarını: their success
kendimi: myself
sakınmış: do not have
götürmüyor: does not take
kurduğumuzda: when we started
dökmelerini: the cast
oğlu: son
bulduğunu: he found
askerlerim: soldiers
endişelenme: do not worry
umudunuz: you hope
cesetleri: bodies
oldum: became
tezek: turd
olmayacaksın: you will not
oldun: you have
çiğnettin: you chew
olduk: we have
derdimize: our troubles
eyledi: he was acting
cevaplayacağım: i will answer
basmanın: press
değiller: they are not
zapturapt: zapturapt
taşımayı: transportation
atarım: i throw
doğruyu: right
atarlarmış: they appointed
casusu: spy
seçtim: i chose
düzine: dozen
zordur: it is difficult
durmaya: to stop
eceli: appointed time
geçmediği: does not exceed
şehzadene: the princes
hayallerine: dreams to
sırpları: the serb
sınırlarımızdan: our borders
bulacağı: will be found
gidiyorsa: if you go
sakinim: i am calm
vereceksin: you give
hâlinizi: your carpet
lanetleyebilirsin: you can curse
yakmıştır: oil has
olmalılar: they should be
yakışacağını: would suit
hayatını: his life
ipine: rope
bekliyor: waiting
hazretleri: his nibs
kötülüğü: evil
karşılık: provisions
temizlediğimde: i'm cleaning
kanatlarının: ribs
etmeyecek: will not
kaygılarım: my concern
veremeyiz: we can not
ölmüş: dead
razı: willing
işte: request
kinle: with that
havariler: apostles
iftiradır: it is defamatory
edebilir: is able to
miydin: did you
gökçe'yi: the gökçee
kuşlar: birds
çıkartıp: remove
peşinden: after
çocuklarını: children
takmadığın: you're wearing
benzettiniz: you liken
getirmelisin: you must bring
yanımda: by my side
zaferler: victories
böylesine: such
rızık: sustenance
yandı: burned
semirtir: will fatten
Şeytan: satan
davet: invitation
niyetinde: intend
vah: woe
emrettiğini: he ordered
topraklarımda: my territory
emniyetinizi: safety of your
iti: push
geçmediğine: pass that
olanı: with
sınavlardan: see exam
obamı: tribe connection
boylamış: have lengths
konuşma: talk
geçeceğiz: we will now
önemli: important
gördün: you saw
başlı: headed
gördük: we saw
taşlardan: of stone
nureddin: nureddin
olmazsam: i'm not
sıkıntı: trouble
kızımı: my daughter
bendir: bender
tartıştık: we discussed
ağlardım: i would cry
erecek: will
sorduk: we asked
neredeydin: where have you been
göstereyim: let me show you
dedi: said
düşelim: düşelim
halbuki: whereas
ayazından: the frost
aldatıcı: deceptive
ayrılın: the divided
kerim’de: in kerime
dilenciler: beggars
zavallı: poor
onlardan: from them
yaverim: i'm lucky
yaverin: the aide
yerinde: in place
fayda: benefit
şenlendirmeye: to cheer
niyeti: intention
yaylılar: strings
bende: me
kaybol: get lost
kuytuya: a nook
gitsin: let go
baharlar: spring on
kısrağı: mares
Ölen: dying
korktum: i scared
olacağım: i will be
yanılırsın: you stumble
kaçan: fugitive
olacağız: we will be
yargılanacak: will be prosecuted
uyandığında: when she woke up
affedilmez: unforgivable
cesetlerin: the bodies
akçesiyle: with reserves
sarayına: palace
medet: help
taşırken: while moving
atmayın: do not throw away
atma: throw
başaramayanlar: who failed
sonra: later
erimi: range of
tedbirimizi: our precautions
düşenlerden: from falling
öldüren: killed
kurtulmuşlar: freed from
varmadan: arrival
getireceğim: i will bring
ağlarına: network to
kısıldık: we have narrowed
ikinize: both of you
ahali: community
İnandığı: believe it
illet: malady
neredesin: where are you
süreriz: we time
hişt: hush
buluşmayabilir: you can meet
kapılı: doors
bölgeye: region
ödeyeceklerdi: they pay
temiz: clean
olana: from
obama: tribe
çadırıma: tent to
aaa: aaa
kabilelerinden: the tribe
İbnarabi'nin: the ibnarabi
utancı: shame
aah: aah
diyecektim: i was gonna say
mektubunda: in a letter
söyleyebileceğim: i can say
alacaksın: you will
sarayını: his palace
hizipler: factions
sır: secret
tutam: pinch
tutan: holding
tutar: amount
edesin: you're
yıl: year
çaresiz: helpless
zorladı: he forced
edilir: welcome
iyiliği: goodness
türklerin: of turkey
bulurlar: they found
turgut'um: i turgut
turgut'un: turgut
dokuz: nine
vazgeçeli: give up the
toprakların: land
beceremezsek: if we do not suck
plan: plan
kül: ash
topraklarda: in the land
görülmüş: have seen
ağa'm: my network
rahatsız: uncomfortable
töremizle: honor our
torun: grandson
yaşatalım: i'm alive
takunya: clog
kardeşlerim: my brothers
güneşin: the sun
düşmesini: falling
bulunduğunda: when found
ışık: light
hazırlıkları: preparations
alamıyoruz: we can not get
şerri: evil
“hayır: &quot;no
hizmetlerinizi: your service
yüzden: why
ertelemek: reprieve
yay: arrow
cenabı: the cenab
soluk: pale
soluğu: breath
uğraşacağına: would deal
kaybetmiş: lost
gerçeğe: reality
uyup: whether
eşiğinde: on the verge of
gerçeği: truth
eyyubi'nin: the eyyubiler
korkmadım: i fear
lâkin: not that
tutmak: keep
emiri: fiat
uyur: sleeps
koyunların: sheep
İyileşip: healed
sanadır: art
tören: ceremony
derli: compact
bitireceklermiş: they'il finish
kaynaklarını: resources
çıkıp: out
borcunuzu: your debt
belalarını: the trouble
telaşlanırsınız: you worry
ses: sound
ser: ser
tamamdır: it is okay
sığırlar: cattle
sen: you
sel: flood
düşmana: the enemy
sesimi: my voice
büyüyeceksin: you'll grow
beyazlıkları: whiteness
düşünürüm: i think
nefesin: breath
nefesim: my breath
emniyetini: safety
düzenlemek: organize
Çocukluğunuzdan: your childhood
adalarından: the island
oldunuz: you have
gitmesini: to go
gitmesine: go to
kader: destiny
vergilerini: taxes
basireti: prudence
şiirler: poetry
yumuşak: soft
verdiniz: you gave
felaket: disaster
kapılarına: the doorstep
gitmeden: you go
cezası: penalty
aptallar: fools
gizlemek: hide
çileye: ordeal
doğruymuş: it's true
sığındığımız: we take refuge
güvenmiyor: does not trust
velİkrâm: velikrâm
bela: trouble
göğsüne: chest
köpeklere: dogs
günde: day
beyinin: the brain
geçmeyi: exceed
isimlerini: names
yiğitliğine: the bravery
yarattılar: they created
eğilmeme: flexural
istilasından: the invasion
gittiğimde: when i went
dükkândayım: i shop
hazırlıklara: preparedness
göğsünden: the chest
türkler: the turks
umduğumuzdan: we hope
geçelim: let's go
akçakoca'm: i akçakoca
derler: they say
çıkış: exit
kafirlerle: the unbelievers
duygun: the feeling
gözlerimizi: our eyes
sanmıştın: you thought
kızdan: the girl
yapabileceğini: you can do
başucuna: reading the
çeyizin: the dowry
beyi: bey
dinleyin: listen
kürdoğlu’ya: kurdoğlu to
kumaşları: fabrics
işimizi: our business
aileyi: family
kadınları: women
kulağı: ear
Öldürelim: kill
geçirdiler: they spent
bilgilendirdi: informed
cehennemi: hellish
belirsizlerin: uncertain
ezildi: he was crushed
kalırım: i stayed
İnsanları: people
aleppo: aleppo
sırtımızda: our backs
olacaksa: if it
kiminiz: whom you
pahasına: at the expense of
yıka: wash
görevden: dismissed
esamesi: the esa
bunaltmayın: do not overwhelm
selçuklu’yla: selçuklu'yl to
istediğimi: i want
zamanlar: times
beylere: beylere
kelle: head
yapabilirsin: you can
İbrahim: ibrahim
ordusu: army
kibarca: politely
beyleri: lords
geçerken: in passing
düşmanı: the enemy
vereyim: let me give you
güvenmişimdir: i always trust
söylemeyecek: will tell
sorarsın: you ask
cenazeler: funerals
derinden: deeply
bakacaksın: will look
böylece: so
korurmuş: he protects
durmayın: do not stop
şehzadelerin: princes of
agabey'i: his brother
kişi: person
duyamayacak: can not hear
açılmıyor: açılmıyor
elimizi: our hands
eğleneceğiz: we will have fun
bitmiştir: is finished
kıyarım: i chop
gençlere: youth
kurttur: it is founded
savaş: war
elimizden: our best
ettiğini: watch it
ilgilendirmez: do not care
görmemeli: should see
üzerine: over
peşindeyim: haunted
evlatları: sons
gideyim: let go
sıkıntılarının: shortage of
öldürücü: lethal
olmamız: we have
ötesinde: beyond
hayal: dream
savunmaktasın: you defend
otunun: of weed
değdi: it was worth
gençtir: are young
hazırlıklarınızı: your preparation
Ölümüm: death
makinesinin: the machine
sesler: sounds
sahibi: owner
birliktesin: get together
açılsın: you opened
cesurlarım: my brave
söz: promise
bekleyin: wait
zorunda: must
verilenler: with
tutarlar: amounts
çıkmayın: the exit
olurum: i will be
yağmur: rain
anlatırken: recounting
itlerin: push the
oluruz: we have
gelirse: if you come
Çizgiyi: line
işler: works
çağırtmışsın: you're invited
kardeşinle: with your brother
açana: open until
pislik: dirt
endişelenmenize: worry
uyandırmak: wake
güvenli: safe
acımdır: i'm suffering
saldırıyor: attacking
vereceğimi: i would give
güvenle: safely
bıçağına: knife to
be: ba
ayrılıyoruz: we leave
hazırlayacağız: we will prepare
ocağımızda: our quarry
baskıncı: the raiders
bu: this
tamamlayamaması: can not finish
adımdan: from step
boyları: lengths
belanın: the trouble
avcı: hunter
“hizmet: &quot;service
ateşi: fire
ezanıyla: with prayer
uymuyor: does not fit
odalarınız: your room
endişelendirmemeliyiz: should not worry
kuzu: lamb
dediği: as well
çalıştık: we worked
hesap: account
çalıştım: i worked
kazanansın: you're winning
selamlamaya: a greeting to
üzülmesin: not worry
kurulduğunda: when installed
başımızdan: our own
düşürmediniz: you drop
yardımları: help
bey'e: bey
bey'i: bey
ulaşınca: reaches
faydalı: beneficial
musibeti: calamity of
gitmeyeceğiz: we will not go
olmamış: never been
varlığımla: my presence
bizim: our
yemekte: eat
anlatırım: i will tell
şehzadelerimizi: our princes
saçmalıyorsun: are you talking
sırma: secrets
şehzadelerimize: our princes
turgut’tan: from turgut
beklediğiniz: you expect
işidir: hears
arsalarına: plot to
&quot;: &quot;
yanında: beside
dikkate: consider
takdirde: if
sözüm: i promise
kıracağız: we break
basarlar: they press
getirirlerken: the getirirlerk
dosyalanmasinda: in filing
ciddi: serious
yüklemek: to upload
boyu'ndanız: you boyu'nda
düşünürsün: you think
kartallar: eagles
yurdumuzu: our country
topraklarının: territory
ailenin: the family
konuş: talk
koşma: running
evdeki: home
kattığı: storey
görüşmek: discuss
misafirlikleri: sojourns
Şahımızla: our shah
kısacık: fleeting
piyasada: market
tanıştırabilirim: can introduce
şüpheleniyor: suspect
usta: master
vebaya: plague
geleneklerimizi: our traditions
istedi: wanted
yollar: roads
bulunca: found by
çıkanı: out of
çullansalardı: they çullans
cezalandırılır: punished
ağzını: mouth
getirecek: will bring
yoklamış: which polls
hükümdarlığıydı: it was reigning
kucağında: lap
söylenir: is said
suratınla: with face
seni: you
keçilere: the goats
papazın: the priest
hazırlandınız: you were prepared
seçtiniz: you have chosen
konuşursa: if talk
yarışıyor: racing
dostlarımızla: our friends
uyuyor: sleeping
yaprak: leaf
halıcı: halıcı
gereken: required
babama: my father
sizler: you
dön: frost
sokakta: in the street
birimizin: one of us
kimsesiz: forlorn
elçinin: the envoy
insanlar: people
evi: the house
birisi: someone
heybeyi: saddlebag
fırsattan: the opportunity
eve: home
güvercinlerimi: my pigeons
savaşına: war on
bey’in: brain
götürmeyi: to take
karım: my wife
başarmak: achieve
uğursuzluk: bad luck
geçireceğim: i'm spending
oda: room
bırakmadınız: you leave
yuttun: you swallow
çöken: collapsible
taşlar: stones
topraklardayım: i topraklard
veriyorum: i am giving
diklenme: threatening moves
kardeşlerin: brothers
zırhını: armor
savaşacağım: i will fight
beylerinden: guys from
davamız: our case
biri: someone
bitireyim: i finished
üzerindeki: on you
kafa: head
Çek: check
ağrısı: pain
çöker: crashes
yapacaktın: going to do
sakla: hide
yetişemedik: we could not make
tanımam: i recognize
hakkınızda: about you
İtirazı: appeals
etmiyorsun: you do not
dolanmış: twisted
obanız: tribe do
kızısın: daughter you
suikastçı: conspirator
açar: opens
söylemeyeceğim: i will not tell
yoldaşlık: companionship
kılıklı: kılıklı
berbat: wretched
saraya: palace
zindanlarda: in the dungeon
baybora'ydı: i baybora'y
ölecek: it will die
muydun: did you
kaçınabiliriz: we can avoid
masum: innocent
söylenenler: sung on
yeğenim: my nephew
düştü: fell
yetenekli: talented
babamı: my father
tabii: of course
başkasıysa: if another
gidebilir: can go
satmasını: to buy
kardeşlerimizin: our brothers
düzeni: layout
sesgitmek: sound go
densiz: dens
geldi: came
tecavüzlerinin: of rape
baba: father
dinlendirebiliriz: can rest
çıkana: resulting in
suçluyorlar: they blame
pençelerinizin: your paw
İyice: thoroughly
lütfunu: grace
yaralıysa: if injured
ancak: but
yalvarıyorum: i beg
peki: well
mırıldanmayın: the humming
of: ugh
cezalandırırdım: i punish
yaşamalı: should live
buralara: here to
etti: it has
devletini: the state
devletine: state
tüm: all
dilinle: language with
tür: type
beni: me
karşılaştık: we encountered
saldırabilir: can attack
herneyse: anyway
yüzümüze: our face
söylemiş: he said it was
sarayı: the palace
ıstırap: misery
attığımız: we take
sultanların: sultans
olduğundan: because
noktaya: point
konuşuyor: speaking
Çünkü: because
savaşçının: warrior
yastıkta: the pillow
çıkarmamız: our removal
açığa: open to
bitmeyecek: will not end
ot: weed
tanığı: witness
kimsenin: anyone
taşladılar: taşladılar
seyyidina: sayyids to
kimseniz: anyone you
vizör: viewfinder
babanızın: your father
tezgâhımızı: our stand
gülümsemelisin: you should smile
devamlılığı: continuity
dayanamıyorum: i can not stand
ölçüsünü: measure
bulundu: found
çıkmak: exit
kolaçan: the prowl
yararlanmaktan: benefit from
tamamen: completely
adamların: men
alp’le: alp'l to
çıktı: output
kabilem: my tribe
dağılır: distributed
şairin: the poet
kabilen: the tribe
unuttun: you forgot
karınlarını: their bellies
iyileşecek: to heal
şeyleri: things
doğan: born
yiyip: eat
vergileri: taxes
verirsek: if data
devletlerin: states
verirsen: if you give
kaçabileceği: how can
vatikan'dan: the vatican
cennetinde: in heaven
ailesini: family
durmadan: nonstop
destekliyorsunuz: you support
kısmetin: the fatality
kaçarken: fleeing
edecekler: you will
olmadığına: not that
kurdoglu'yu: the kurdoğlu
düzeninde: in order
soracağım: i will ask
felaketten: from disaster
kaçın: avoid
gibiyim: i'm like
efendisini: the master
ihtiyarlar: the old
hizmetinden: service from
sürümleri: versions
alaaddin'in: the alaaddin
ağzından: mouth
kaçıp: escape
feryatlarına: screams
savaşta: in battle
atlarını: horses
gibiyiz: we are like
isterse: if you want
yatarken: lying
kurulur: board
çemberini: circle the
tuttuklarının: they keep
almalıyım: i have to get
bölge: region
alışınca: accustomed
Şehre: city
Özür: apology
hafif: light
bırak: leave
aziz'den: the honors
çıkanlara: to the
vermeyecekmiş: going to give
komutanının: the commander
çukura: pit
bak: look
alplerimizle: our alps
kaçtığınızı: how you
gitmiş: gone
takdirinin: of appreciation
girerken: entering
almayı: take
koçyiğitlerin: koçyiğit of
sığındı: he took refuge
yazıklar: shame on
harcayamam: i can not spend
kavga: fight
otağına: tent to
görevlendirdim: i have appointed
yine: again
dinliyorum: i'm listening
yandan: hand
olmadığını: whether
onurumuzla: honor our
hatalısın: you're wrong
gidersiniz: you go
ağalar: ağalar
tutacaksın: you keep
elindekini: elindekini
zarif: elegant
bakamazsınız: you can not look
korkuyorum: i'm afraid
kaçıracaklar: will miss
kutsaldır: it is sacred
bakmayın: look
argos: argos
kalbinizi: your heart
etmeme: not to
ceylan: gazelle
konuştunuz: you spoke
kokarca: skunk
askerimizi: our military
adamının: the man
savaşıyoruz: we fight
sürülere: lot to
bilgilendirmeliydin: you should inform
eyle: eyle
harcamaktan: spending
güvendin: you trust
bakarak: looking
problemin: the problem
eşkıyası: bandit
leşe: carrion on
törelerini: the ceremony
dolusu: fill
kaçma: escape
çıkacak: will be
vizierimiz: our vizieri
almaya: take
götürdün: you take
gönderebilecek: can send
senelerce: for years
bitecek: will end
şehirlerde: cities in
arkada: behind
sıkıntıda: stranded
düşündüğün: you think
görmedim: i did not see
nasır: callus
gelecektir: will
uyumamıştım: i had not slept
inanmadım: i did not believe
eyledik: we act
hayran: fan
nasıl: how
yükünü: load
havası: air
Şövalyeler: chivalry
demeye: to say
ailem: parents
kurtulmuş: rid
akcakoca'yı: the akcakoca
kuracak: will establish
komutanmışsın: you commander
olmalıydım: i should have
kazdığım: i dig
bereketlidir: is abundant
vermezdim: i would not
duyardı: he heard
umursamıyorum: i do not care
köslerle: with drums
torunu: his grandson
İyiyim: i'm fine
evvela: firstly
yüzümden: my face
durursunuz: you stand
savaştık: we fought
rüyamda: in my dream
ulaştı: reached
istemiyor: does not want
savaştın: you fought
ödeyeceksin: you'll pay
bilinemez: not known
dünyasına: the world
tutuklandı: arrested
oturmaktan: to sit
işgal: occupation
gebereceksiniz: dyin '
kokuyorken: the kokuyork
yıkansam: wash possible
alpsungur'un: the alpsungur
saplama: stud
avlandım: i hunted
boyu'nda: in height
yıkarken: when washing
edilen: tagged
yazıya: type
benliklerinizin: your self
dövülmediyse: if beaten
duracak: will stand
devşir: are recruited
toplanıp: collected
kaçsın: are few
merkezimizde: our center
halkımız: our people
kafam: my head
kafan: head
çektin: you pulled
papalık'ta: the papacy
kınına: to sheathe
çektik: we shot
fesatlık: mischief
ödedim: i paid
beceremeyen: incapable
suçladıktan: you blame
dostlarımıza: our friends
kızlarını: their daughters
“bir: &quot;one
alayım: alayım
kaybettik: we lost
kaybettim: i lost
kaybettin: lose
oğul: son
olasın: the possible
göğsün: chest
etrafa: around
yâr: yâr
etrafımızda: around us
Şemsettin: şemsettin
doksan: ninety
oğuz: oğuz
ülkeyi: country
eti: meat
oynaş: fool around
dünyasını: the world
olaylar: events
beklemiyordum: i did not expect
atmış: tossed
azam: azam
görevin: the duties
sevginin: love
dibine: the bottom
Âli: ali
toparla: gather
çullanmak: sweep down on
sevginiz: you love
soyuna: strain
çıkarlar: interests
kıracağımı: i broke
kışkırttı: provoked
kayalarda: on the rocks
rüya: dream
ölümden: death
tezeğe: the dung
soyunu: strain
günlerce: for days
güç: power
rahmet: mercy
rehin: pledge
misafirin: the guest
mukayyet: mukayyet
ezilirsiniz: you will be crushed
çıkamayacaktık: would not go
uzaktaki: remote
gönderen: sender
benimkiler: mine
olacaktınız: you would be
vurma: hit
öldürürdüm: i'd kill
sevgilimden: from darling
nefesinden: the breath
üzerinden: over
görünürde: in sight
yolunu: the way
görerek: seeing
söylerseniz: if you say
ve: and
dilimde: slices
ağrın: the pain
görür: sees
yoluna: way to
buraların: here the
zehirlendi: it was poisoned
uzaklaşma: divergence
emirliği'nin: emirate
üşüdüm: i'm cold
gür: bushy
beklerken: while waiting
ilgilensin: take care
göçler: migration
gül: rose
gün: day
boğazımızın: our throats
izinde: footsteps
yapmaz: do not do
birden: suddenly
evcilleştirildi: it was domesticated
Ölülerini: dead
başlarsa: if it begins
keçi: goat
ettikten: meat you
yapmak: make
yapman: do not
iken: while
ödüyor: pays
yapmam: i do not
dayan: hang on
şeyler: things
döşeğinde: on deathbed
sallamaktaki: maktaki shake
söylenemez: said
eminim: i am sure
emirlerini: the commandments
yaranı: wound
diyecek: i will say
güvercin: pigeon
toygar'dan: from meeting
anladım: i understand
anladın: you understand
yüklemezsin: do not install
selâmeti: salvation of
konya'ya: konya to
esir: prisoner
zaman: time
altında: under
İstersen: if you want
katlanamaz: can not stand
kanına: blood to
ablasına: ablana
gündoğdu’nun: the gündoğdu'nun
gidecekler: will go
emirleri: orders
maşallah: by Allah
otak: otaku
hizmetinde: in the service
ihtiyacı: need
ışığıyla: with light
hayır: no
işine: job
gözün: the eye
gözüm: my eye
bozulur: disrupted
sanıyordum: i thought
sanıyordun: you think
işini: your job
orasını: the ratio
uyan: wake up
karına: abdomen
toygar’la: toygar'l to
ateşlerken: when firing
kazandırıyor: brings in
kızda: in girls
sahabettin'e: şahabettin to
çobanının: the shepherd
sürünüz: apply
yabanın: the wild
yiyeceksin: get food
gelebilir: may come
bulduk: we found
buldun: you found
buldum: i found
erkenden: early
hamlesini: moves the
yollardayız: on the road
ulaşmaya: reach
yönlendiremezsin: you direct the
doğrusu: actually
değişikliği: change
yiğitlerin: the valiant
yiğitlerim: my brave
lanetli: damned
çalışmam: my work
çalışmak: work
lokmanızı: bite you
şerefinizdir: is your honor
atanın: assign
aldık: we received
aldım: i got
halep'e: halep to
çekilir: trailed
halep'i: the halep
dolaşın: stroll
konuşalım: let's talk
gidiyoruz: we are going
konuda: subject
evimizde: our home
barışabilsin: allow peace
merak: wonder
tanıştığımız: we met
aleyhinize: against you
geceni: the night
edenlerden: those who
Şah'ından: shah
karını: profit
dağı'nı: the mountain
kudüs: jerusalem
inanmıyor: does not believe
aydınlanmaya: enlightenment
dayıcığım: my dear uncle
zulmünün: of persecution
yapmazsan: you do not
baltası: ax
casusları: spies
saymıyorum: not to mention
olabiliyorsun: can you be
yiyeceğimiz: we eat
sırada: ranked
olmamızı: that our
istiyorlar: they want
üzgün: sad
tepelemek: hills to
mallar: goods
kanını: blood
kaleye: the castle
babaya: father
tuttun: you hired
konya'yı: konya is
iştir: work has
hoşgeldin: welcome
hükümler: provisions
sevilmez: not liked
zehir: poison
yüreklerimizden: our hearts
halep’i: the halep
halep’e: halep to
saygıyı: esteem
getirebilirsen: could bring
problem: problem
bizimledir": he is with us &quot;
affet: forgive
soyumuz: our descendants
kalmanda: having
damga: stamp
hayattasın: you're alive
eteklerinde: foothills
şeytanlara: the devil
savaşçılar: warriors
gelince: as for
şikayetçi: complainant
çıkamayacağız: we can not
alâaddin’in: alaaddin
zorbaları: bullies
çocuğu: children
telef: waste
neye: what
babamdan: my father
çocuğa: children
sulandırmak: reconstitute
gönder: send
korkar: fear
ölürdüm: i would die
işkencelere: torture
yıkacakmış: yıkacakmış
kılıçları: swords
bakmaya: look
Şah: shah
sahibiz: we have
katılmamı: my participation
Şam: damascas
yaymaya: spread
girmeden: without
türkmenlerin: of turkmen
konuşabilir: can speak
ilgilenirken: dealing
bebeğim: my baby
çekinceleri: reservations
hakkımız: our right
bağışlarsan: if you donate
örtüsünü: unveiled
bağlayın: connect
abdülkadir: abdulkadir
kuşananın: put on the
kirletmeye: pollute the
konusuyla: by subject
kurtarmamız: our recovery
hayırlı: good
davrandığımızı: we behave
onur: honor
bununla: with this
gölgelememesi: the shading
inşallah: god willing
çalışmasında: in the study
kahraman: hero
“hadi: &quot;let's
webvtt: webvtt
görebilirsin: you can see
ölümünün: of death
konuşacaktım: to talk
ölümünüz: your death
taşında: transported
kulübümüzde: our club
kısraklarımızı: our mares
yorgunusun: you are tired
sabırsızız: impatient
"korkma: &quot;do not be afraid
başım: head
başın: press
hesabımız: our account
düşünülmüş: considered
yaralı: wounded
karavandaki: the caravan
amcan: uncle
amcam: my uncle
dostlarımız: our friends
erzincan'daki: in erzincan
zorundayım: i have to
söylemeye: tell
hatunu: chick
cenazelerden: the funeral
akıbeti: fate
yollarına: way to
zorundayız: we have
doğacağı: will be born
kolumuz: our arm
hazırlıklar: preparations
başarısızlığın: failure
zindan: dungeon
öldür: kill
çıkacağı: will come
engelle: block
babası: father
kışın: in winter
beyimizi: our brain
suç: crime
yargılandığına: that trial
beyimize: our brain
kötülük: evil
yardımcı: helper
kurdoğlu'yla: kurdoğlu'yl to
bitirin: complete
padişahtan: the sultan
öfkeden: with anger
verdik: we gave
aylarca: for months
verdim: i gave
verdin: you gave
canımızı: lifes
şükrederiz: we give thanks
taraftan: from the side
bilene: who knows
hissettiğinde: when you feel
dize: verse
düşme: fall
eşeler: dig it
aciziz: unable,
tamamlayacağım: i will complete
emrinde: under
geylani: geylani
zorlu: tough
kâbustan: the nightmare
zorla: hard
bre: bre
korumaktan: to protect
geldiğinizi: you come
rahatın: comfortable the
mumları: candles
saran: wraparound
oynasın: you play
çıkmıyor: will not come
elçilerinin: envoys
bilgi: information
aşiretler: tribes
küçülmüştür: shrank
hanedanlarından: the dynasty
giovanni: giovanni
bilge: wise
düğünü: wedding
eziyet: grind
kolayca: easily
sultanın: the sultan
kardeşine: brother
kalkma: up
sakladığı: keep it
olmanın: do not be
cevap: reply
alıyorsun: you take
güne: day
kanımdır: is my blood
şansın: the chance
eri: eri
duymadın: you heard
duymadık: we heard
bitmedi: finished
yiğit: valiant
hicret: emigration
İnsafmış: have mercy
giderken: en route
kendinize: yourself
kişisel: personal
teslim: delivery
salladım: i shook
kendinizi: yourself
Çan: bell
atına: the horse
Şahzade: in şahza
sever: lovers
alacaktır: will
bilmezler: bilmezler
yapacağımız: we do
yapabileceği: can do
laf: word
kızıdır: girl is
bilmediğin: do not know
kayınbabamın: my father in law
beklersiniz: you expect
karşılayalım: i greet
adil: fair
bükülmedin: you bending
kızınızla: your daughter
varacağını: there will
hediyeler: gifts
hasta: patient
ölümünden: his death
pusudan: the ambush
kuraklık: drought
düşürdüğümüz: we lowered
rozalina: rozalina
koşacağı: will run
içindeymiş: he was to
kollarımda: in my arms
ötesine: beyond
ameer'in: the ameera
somunu: nut
konuşulurken: spoken
İkincisi: latter
bilirim: i know
biliriz: we know
yelkesen: the yelkes
marsilyalılar: marseillaise
söylerim: i say
programlarını: programs
arkadaşı: his friend
kullandı: he used
vaktin: you have time
bahanesiyle: under the pretext
ceylanla: gazelle
kibrini: arrogance
boğazını: throat
aferin: well done
çabalarınız: your efforts
basabilir: you can press
gösterdi: showed
soran: inquiring
düşündüğümüzden: we thought
geliyor: coming
muhtemelen: probably
götürecek: will take
kurutacağım: i will dry
gelmesi: arrive
belirlemek: determine
halindeler: into
cezayı: penalty
mezardır: it is the grave
korkacak: to fear
arkandan: from the rear
emanetini: entrusted to
kalanları: the remaining
çıkmalıyız: we have to get
İntikam: revenge
böyle: such
gundogdu: gundogdu
kaldıracak: will remove
oğlumla: my son
yanlışsın: you are wrong
güvendiğimi: i trust
yoldaşlarınızı: your companions
teşekkürler: thanks
anlık: instant
balina: whale
aşağıda: below
baklayı: beans
kadirsin: you magnitude
yolundur: download road
kırmak: break
kellenizden: your head
söyleyeceğini: he would
İntikamımı: revenge
sopasını: stick
arkamıza: behind us
yiğitlerimiz: our valiant
yerin: the place
madencilerin: miners
denizine: the sea
yerim: i eat
olmak: be
suçlama: blame
böylelikle: thus
merhamet: pity
olmaz: no way
meseleler: issues
yanılsama: illusion
geldiler: they came
dalda: branch
kurutulmuş: dried
ağızını: mouths
açtığında: when hungry
şehzademdi: the prince now
gönderin: send
gönderir: sends
kelebekler: butterflies
endülüs'ü: the andalusian
vurduğunu: that hit
boğazına: throat
kabilemizdeki: our tribe
beslemelerimiz: our supply
yiyen: eater
bulabiliriz: we find
birisinin: one
dönmek: return
dönmen: rotation
inatçı: stubborn
iftira: slander
gecesinde: at night
kanımıza: our blood
koyamaz: can not resist
gerekiyorsa: if you need
sorunların: issues
beyleriyle: guys with
gibi: like
sarayımızda: our palace
dostluğu: friendship
zira: for
endülüslü: andalusian
masallar: tales
bebe: babe
zülcelâli: almighty of
hanım'ı: wife
dolaştıran: circulating
emir'den: orders from
aykız’la: aykız'l to
ayrı: separate
koşup: run
dilde: in the language
yaşamayaydı: it was living
aykız'ın: the aykız
İyi: good
etmenin: the factors
emredersiniz: yes, sir
yiğitlerimizden: our brave
samanlığın: the barn
kıyaslama: comparison
hakkımı: about me
zikrullaha: remembrance of Allah
bizzat: personally
sakalımı: my beard
kumaşımız: our fabric
yürü: walk
satmak: sell
söyleme: mention
avlayalım: i hunt
cevizin: walnut
sıcak: hot
böyledir: is such
öğrenecekler: learn
keskin: sharp
roma: rome
zindanların: the dungeon
düşmanımı: my enemy
götürüyor: taking
görevlerini: their duties
kurdoglu: kurdoğlu
şekilde: the way
selcan'ın: the selcan
görse: gorse
Çatır: roof
yiyelim: let's eat
allameye: all standards
hayattadır: it is alive
askerini: soldiers
istişare: consultation
ağır: heavy
kolye: necklace
kayis'in: the straps
olmasını: not the
üyelerinin: members of
yanarsınız: since you
tanrı'dan: from god
inanabilirsiniz: you can believe
vedalaşmam: i say goodbye
yel: wind
obasının: of obama
başladı: started
dönüştüğü: the return
bakabilirim: i can see
toygar'ı: meeting
beyimizin: our brain
anlamıyor: does not understand
atalardan: from ancestors
susacağım: i'll shut up
yarınki: tomorrow
çekinmeyin: feel free
yarılsın: you split
anlattı: told
da: in
gitti: gone
korkağa: funky
çekinmeyiz: we do not hesitate
atalarım: my ancestors
sırtıma: on my back
bulmak: find
söylerdin: tell you
karşımıza: us against
öderler: they pay
Çocuğunu: children of
sunacağım: i offer
tarafın: the parties
olmaktan: being
altındaydı: gold was
katletmişsiniz: you murdered
ayrıldığımda: when i left
diyorsa: if he says
mühletiniz: you respite
diyor: says
savaşın: fight
sırtından: the back
uğradığın: stoppin '
soylansın: you soylan
bırakma: release
mantık: logic
getirsinler: they bring
babam: my father
baban: your father
borcum: my debt
bulamazsınız: you will not find
gitmeleri: go
iyilikle: kindly
sanırım: i think
ayağınla: by foot
bisol'ü: bisol'ü
halletmek: unzip
kayıların: boats
ileriye: forward
gidecekti: would go
öldürme: kill
efsanevi: legendary
gözlerime: my eye
ile: with
muhammed: mohammed
akıllan: mind that
konuşabilirim: i can speak
ilk: first
gözlerimi: my eyes
girilir: entered
putunu: idol
camilerinde: in mosque
otlatacağımız: will graze
müdür: manager
karşıma: my face
dönmüşsün: you're back
burdasınız: you are here
güveniyorum: i trust
uzaklaşmayacağım: i'm going away
yorumlayabilmesi: comments can
Çocuklarımız: our children
Çatışmada: conflict
yığını: stack
yasını: mourn
yaylaların: springs of
gayret: effort
ilgilenelim: i take care of
hançeri: dagger
tanrısal: divine
yetkili: authorized
muhafızlarının: guards of
elanora'nın: the elanora
gözündeki: in the eyes
üstlük: seniority
ödeyeceksiniz: will pay
çıkaracaksın: you're gonna
başlarında: earlier
öptü: he kissed
umursamıyorlar: they do not care
cihanda: in the universe
kampanyası: campaign
leila'ya: leila a
döndüğümde: when i returned
olmasına: not to
vakti: time
eğmek: tilt
bilmeyenler: bilmeyenler
kurtarmak: rescue
ait: belonging to
aldı: took
servete: wealth
siman: cement
kurarız: we will
yongam: chip
dönüştüğüne: return that
kafes: cage
Âmin: amine
konuşuruz: talking
tutamadan: held without
yerleşsin: get settled
gidiyorlar: they are going
tanıştık: we met
hanedanı: dynasty
mektupların: the letters
düşürün: decrease
kıyar: the meat
uyuyun: follow
musa: moses
bakın: look
hani: behold
nasip: grant
kaderini: fate
nasir: callus
kafasının: head
bulacaksınız: you will find
bilen: knowing
nasipleri: their share
kınık: cynic
kardeş: brother
hazırlıyor: preparing
ölmesine: die
balığın: fish
yaprağı: leaf
aptal: silly
kale: castle
unutmamalıyız: we must not forget
kalk: up
efsane: legend
yanıma: yanıma
kalp: heart
geberttiğimiz: we kill
tedbire: measures to
üst: upper
geldiklerinde: they come
askeri: military
askere: soldier
yanacaktı: side would
emelimiz: our emelie
giriyor: it is entering
karnaval: carnival
söylersin: you say
zehirlere: the poison
temizleyemezsin: you temizleyemez
göğsümüzü: our chest
arar: search
düzenleme: arrangement
haçlı: crusader
selamlasın: hail
olurdun: you'd
rahman: rahman
olurduk: we would
izini: permit
allah’ın: god
üzereyken: goal
bahsettiniz: you mentioned
görünsün: you seem
süleyman: suleyman
duruyordu: he was standing
derdi: say
elçisidir: envoy is
beyazlatmalıyız: we need to whiten
shahzade: in shahza
derde: trouble
aldınız: you received
gölgenin: the shadow
şansı: chance
salim: safe and sound
görmedin: see you
merhemleri: ointments
antakya: antakya
koruyamadı: failed to protect
beylerinin: the gentlemen
sende: cents to
gevşerse: if unwind
prenslere: the prince
işin: ray
işim: name
Şövalyelere: the knights
prensleri: princes
geldiğini: that came
almazsak: if we do not get
işit: hearing
kardeşliğimiz: brotherhood
vücudu: her body
koymasam: i koymasa
kırıklığına: disappointed
herhâlde: i suppose
zoraki: forced
vücuda: the body
oğlumu: my son
sorumlusu: responsible for
bağdat'a: baghdad to
oba: tribe
yaptığınızı: do you
vermeyecek: will not
niyetini: intention
belirle: determine
beyazı: white
dönmeyecek: will not return
niyetine: intention to
üç: three
yatılacak: to boarding
emir'in: the orders
acıyor: it hurts
görmeliydin: you should have seen
sonuna: to the end
işlerimiz: our business
"dikkatli: &quot;careful
güzel: beautiful
Şefi: chief
yemeyeceksen: if you're gonna eat
iletişim: contact
yüreğin: heart
akrabaları: relatives
umudumuzun: our hope
gördüğümüzü: we see
yüreğim: my heart
çifte: double
söylemediğin: you say
topraklarınızda: your soil
zalimin: the cruel
kıldan: to make
kaybolmayın: do not get lost
Ütü: iron
söylemiştim: i say
İlyas: elijah
düşünürdünüz: you think
emin: sure
rengi: color
göndermezse: do not send
&quot;kaderini: &quot;fate
hayali: imaginary
almadan: without
isim: name
emir: order
yolculuğunuz: your journey
bilmeye: to know
anlatmana: tell the
yetişmezse: does not reach
sofrada: at the table
diyeceğin: you say
Şüphelendiler: they suspect
direniyor: resisting
Çocuğumuz: our child
zalim: cruel
devlette: the state
vurduğun: you hit
endişeleniyor: worried
girecek: will enter
maval: fuck with
misafirine: visitors to
verdiğimiz: we give
gergin: nervous
test: test
cüssenle: with bulk
anlayacak: to understand
biraz: some
selçuk: selçuk
ihtiyaçlarını: the needs
şehit: martyr
şehir: city
gelmediğinde: when coming
atlanmış: omitted
yanlış: false
ihanetten: treason
oğlum: son
oğlun: your son
çiğnemez: do not chew
yüreğimiz: our hearts
salgısı: secretion
gavurun: the infidels
koyun: sheep
alplerimize: there alps
çevirsin: you turn
sevinir: rejoices
yapıyorlar: they are doing
alplerimizi: our alps
hapishanede: prison
odaya: room
kurtulamayacaksınız: you will not get away
haklı: right
lider: leader
kabilemizin: our tribe
önünden: front
beklerim: i expect
rahatlık: comfort
bakacağız: we will look
Üstadı: master
minberi: pulpit
geldiğin: coming
efendimiz: sire
dışarı: out
alplerden: the alps
öldükten: he died after
düşürecek: to reduce
ölen: dying
vebali: smitten with the plague
güvenmezsek: if we do not trust
cevapların: the answer
sorunlardan: the problem
kurtar: save
ağabeyini: his brother
haykıracaklar: they cried
tanışmak: meet
tedbirleri: measures
karmaşık: complex
ettiğinde: when
ertuğrul'un: ertuğrul'un
çekinmeyeceğiz: we will not hesitate
açlık: hunger
herkesten: from everyone
kıpraşıp: kıpraşıp
oturduğu: his seat
şüpheleniyorsun: you suspect
göçerlerin: of nomads
görmediniz: you have not seen
güvende: in confidence
unutma: keep in mind
yapacağımızı: we do
dökülen: pouring out
yıkamamı: wash my
avrupa'daki: in europe
lafı: remark
sefil: miserable
fazlasını: more
misli: fold
anlatayım: let me tell
kontluğu: county of
bakmasını: look at the
kışları: winter
çalının: stolen
kahramanı: hero
oturmayı: fit
yemem: i do not eat
diyorsun: you say
çekmeyecek: will pull
hareketli: active
gelmelerini: arrive at the
yetişmez: yetişmez
bunun: it
kaçacaklarmış: how many they'il
yolcu'sun: you passengers
tutuyorlar: they're keeping
nasılsın: how are you
dünyasında: the world
aşalım: i alloying
gerekeni: needed
tazelik: freshness
rehberimdir: i'm directory
hamza: hamza
yardımcınız: your help
konuklarını: guests
davulcular: drummers
güneşte: in the sun
dolaşıyor: touring
zaafa: weaknesses in
bebeklerden: the baby
yapsın: you do
petruccio: petruccio
ayakçısına: errand to
selçukluları: seljuks
kaçırmışlar: they kidnapped
tadacaksınız: you will taste
düşün: think
oyunculuğu: acting
toplayacaksın: will gather
kalkacak: will be lifted
hızır: speed
verirse: if data
yapmamızı: do our
evlatlar: progeny
unutturdu: to forget
odayı: room
hepimizi: all of us
İsyan: revolt
çekinmemeliyiz: should not hesitate
ibn: ibn
hamza'nın: the hamza
elimdeki: in my hand
edelim: let's
sakinleşin: calm down
beylerine: the gentlemen
can: bell
dibinde: in the bottom
diyemedik: he did not
ruhları: spirits
cennetine: heaven to
şerefimizi: honor our
Çalışmalarına: to work
kahramana: hero
büyülenecekti: it would have fascinated
öldürmeni: killing
sınavını: exam
koyacaktın: you'd put
iktidar: power
aziz'e: honor
saklandın: you hid
söylemedim: i do not say
söylemedin: you did not tell
giyaseddin: gıyaseddin
paramparça: in pieces
yetiştiririz: we grow
alıyor: taking
görmesinler: let them see
çileli: çileli
gerektiriyorsa: if you require
filistin'den: from palestine
olacağını: would be
Üzülüyorsun: are you upset
hatırlatacaksın: you're gonna remind
katar: train
sizinle: with you
güvenmiyorum: i do not trust
sonraki: next
Şüphe: doubt
itiraz: objection
seversen: if you love
itiraf: confession
çırpınır: beat
yolladığım: i sent
kurt: wolf
affedeceklerdir: will forgive
taşıyan: bearing
amcamın: my uncle
ulan: ulan
verilen: given
sesimin: my voice
binlerce: thousands
amcamız: our uncle
olmadığı: it is not
kıyamet: apocalypse
yapması: making
baston: walking stick
ayrıldık: we left
zinciri: chain
beyrek: beyrek
enne: enna
haberini: news
kapılar: doors
alçaklığı: treachery
yarın: tomorrow
Çakallar: jackals
yarım: my love
uzağa: away
vazgeç: give up
İnsan: human
doğarken: daybreak
vahşileri: the wild
ödeteceğim: i will repay
hala: still
tugrul'un: the tugrul
anası: mother
hali: status
alimallah: alimallah
şeyin: thing
hükmetti: he ruled
soylular: nobility
dolaş: around
şehzadeleri: princes
düğümlenen: knotted
akrebin: scorpions
kere: times
Çin'de: in china
el: hand
en: most
ee: ee
ciğerimiz: our dear
baltayı: ax
ey: oh
et: meat
ev: home
laflarımı: my words
verdiği: tweaking
er: er
Şah'a: field
durdurmuş: stopped
geleyim: i come
göremiyorsanız: you do not see
yemyeşil: green
kırılıyor: is breaking
bakmak: look
’sına: 'test
büyüdüğümüz: we grow
metanetli: fortitude of
bakmaz: does not look
yavaş: slow
dokunulmaz: untouchable
malını: possessions
ışıltı: light
bitmemiş: unfinished
istiyorlardı: they want
anlaşıldı: roger
artıklarından: from now
bahsetti: mentioned
etmeseydim: i had not
zamandı: time
halı: carpet
düşmanın: the enemy
nimetini: blessings
kibir: arrogance
kulübede: in hut
konuşmanın: speech
uyudunuz: you slept
arada: between
sizi: you
sadede: simply
İyisinizdir: you're good
görevinden: task from
size: to you
başla: start
sorunlarınızı: your problem
olmadığından: it is not
herkese: to everyone
zincirledin: you chains
silinsin: delete
kastettim: i mean
kardinalin: the cardinal
gönderildik: we sent
evdir: the house is
yakaladık: we caught
korkuyor: afraid
hazineyi: treasury
kazanması: win
yardımına: help
gökçe'nin: the gökçee
mıydı: was
öldürülen: killed
avrupa'yı: avrupayı
Şah'ım: shah
Şah'ın: hawk
fikri: idea
güreşelim: i wrestle
geldiğimizde: when we come
görmüyor: does not see
yaşlanınca: old age
yanmasın: you're burning
kökenleriniz: your descendants
edemedim: i could not
bekası: survival
intikamını: revenge
ruhuma: my soul
kısa: short
belada: in trouble
orospu: bitch
hâldedir: is still
kubbeyi: dome
bırakmaya: leave
titus'a: titus to
ruhumu: my soul
milletin: the nation
birleşmiş: united
götürün: take
üzerimden: off me
dayım: my uncle
dünkü: yesterday's
zamanda: time
Çocuklardan: from children
tuzak: trap
ipleri: ropes
bisol'ün: bisol'ün
alnujum”: i alnuj &quot;
götürüp: take
götürür: take the
görürsün: you see
mesud: mesud
geçtiğini: it now
Şehzadeleri: princes
kitaptır: is the book
etsin: you've
majesteleri: your majesty
suyunu: water
üstünden: across
ortadan: the middle
numan: numan
arkadaşlarına: to your friends
tutsak: prisoner
kanı: blood
mağaradan: from the cave
anca: barely
Şah'ı: actually
eğ: tilt
dölüyle: the offspring
papa'nın: the pope
doktor: doctor
kendinden: self
şahitliği: testimony
elanora'mızı: our elanora
tartışabilirsin: you can discuss
kendi: own
açmasından: from opening
aşireti: tribe
ailesi: family
adamsın: you are man
Çadırı: tent
cefakâr: longsuffering
yanarsın: since you
kanlı: bloody
kaçıracak: will miss
taşıyacağız: we will move
kılıcını: sword
açmış: opened
edeceğinizi: will you
getiriyorum: i bring
keşkülüm: my pudding
taşıyacağım: i will carry
yücelttin: you glorify
konuğumuzu: our guest
uçuşuyor: fly away
tüccarız: we wide
yaşlarındaydık: years old and
uyutmak: anesthetize
içti: drank
zengindik: we have rich
tüccarım: merchants
tüccarın: traders
günden: the day
başardık: we were able to
resulühü: the resulüh
müjdeliyor: heralds
diyoruz: we say
kocan: stub
kocam: my husband
göçmeden: without collapsing
yönetim: administration
diyorum: i say
güçlenerek: stronger
eylediler: they act
yapardı: he would do
peşindesin: you're chasing
silahlarına: weapons to
kâfirlerin: of infidels
mısınız: are you
şuna: following the
mezarı: grave
şunu: it
duyacağımı: i heard
gelsin: you come
sattığınızda: when you buy
kullanırım: i use
yaşayacağız: we will live
irak'taki: in iraq
sorarsanız: if you ask
günümüze: today
göndermek: send
kudurmak: rage
başımızın: our heads
yapmayın: do not
çığırtkan: barker
rahminde: in the womb
yolunda: right
girdiğinde: when
hallerinin: of cases
müşrikler: polytheists
verİlmemİŞdİr: verilmemişd is
vur: hit
getirmesini: bring the
zarar: damage
umduk: we hope
kurdoğlu: kurdoğlu
onlarsız: without them
enerjimi: my energy
umutlarını: hope
çadır: tent
titriyorsun: you're shaking
hayvanlar: animals
bozdu: overturned
alacalı: mottled
ih: exp
Ölü: dead
âşıklara: to love
sesi: sound
cenazelerimizi: our funeral
turgut'umla: with turgut'u
hakimiyetin: the dominance
deresi'nde: in stream
vazifemi: my task
olayın: event
olayım: event
ebeyi: midwife
devirmek: overthrow
köklerini: the roots
gözüne: out
sayısı: number
yaşamdan: from life
kafamdakini: listed in my head
sızamazlardı: they sızamaz
demir'i: iron
kanla: blood
düğün: wedding
kılıcına: the sword
rahme: waft
suçun: crime
başıbozuk: irregular
şükrettiğim: i thank
devletimden: my state
bitir: finish it
geçirmemiz: our goals
bırakmayız: we leave
babamdır: is my father
dostlar: friends
kervanın: the caravan
töresine: ceremony to
anadolu’daki: anadoludaki
anladığımız: we understand
başladığımızda: when we started
yanaklarınla: your cheeks
töresini: the ceremony
sordum: i asked
ulaşması: reach
kolyesi: necklace
sordun: you asked
müzik: music
atlattı: survived
sahte: fake
yetişirsiniz: you reach
musunuz: do you
lakin: not that
haklarını: the rights
korkuları: fears
emanetlendiniz: did you emanetl
kırmalıyız: we should break
aklıma: to my mind
görebilseydi: he could see
çürüdüğümüz: we rot
yarını: tomorrow
allah'ıma: allah'ıma
kulaklarımla: my ears
ağrıyor: hurts
inceliğini: tact
gerekirdi: should
kıymetli: precious
toplamaya: collection
çalıştığım: i tried
çalıştığın: you work
yeğenindedir: nephew
kırıldı: broken
zannetmiştim: i think
utançla: shame
nereden: where from
ucu: tip
sığınırız: we seek refuge
selçuklu: selçuklu
amcamdan: my uncle
erkeğin: men
kalıcı: permanent
sırrını: secret
felaketidir: disaster is
seviyor: love
ananla: main with
sevgili: dear
yazıyı: article
kapı: door
marcus: marcus
ama: but
cehenneme: hell
yaralandı: wounded
alpargu: alpargu
etrafta: around
saklarım: i keep
kalkmış: up
zülfikar'dan: on the strength of
istemiyorsan: if you do not want
bulandırırsın: you confound
dövülmüş: beaten
sevdiğim: favorite
görevim: my duty
şeref: honor
gitmelerine: to go
malum: inevitable
aldığımı: i get
müjdecisi: usher
seyirci: spectator
babacığım: daddy
söndürdüm: i put
oturmak: sit
altını: gold
aykutluk: aykutlu
hazırlamama: preparing to
çatıyorsun: you're the roof
yapmamı: make my
çıkıyoruz: we're going
çağırmışsınız: you call
yaşam: life
altındadır: it is under
yaşar: live
zamandır: time
teessürlerini: their sorrow
çıkıyorum: getting out
oğlumuz: our son
viran: ruinous
kıyısında: on the coast
vardığı: there he
afişi: poster
aykız'dan: from aykız
uygun: appropriate
kısası: retaliation
düşsün: you fall
anlamına: meaning
tenezzül: stoop
tamamlanmış: complete
yakalanırdık: we caught
bilir: knows
bilip: knowing
kalbimizle: our hearts
derse: course
sırrındaki: in secret
İşaretim: signaling
itibarım: my reputation
kılacağız: we will make
isteğinin: the request
yakınsın: get close
musun: do you
sınavı: exam
etmez: does not
istersiniz: do you want
yaşayabilir: viable
oldukça: quite
isteğiniz: your wish
sınırları: borders
bulunmalıdır: there must be
yayıldı: spread
yiyecek: food
Çok: very
izlerken: watching
emirlerin: of orders
sınavda: exam
söylersem: i say
bitti: it's over
kapa: collapse
ganimetlerle: spoils
başlardı: he began
miadı: miat
denmez: not called
gündoğdu'yu: the gündoğdu'nun
altına: under
yaptığımda: i did
bağrışma: hue and cry
kayalar: rocks
gündoğdu'ya: gündoğdu
etmemi: to my
ustaca: masterful
karnını: belly
bilmesen: i did not know that
utanmadan: shamelessly
geçişi: transition
paralık: penny
heybemize: our saddlebags
mutlusun: you are happy
üstelik: moreover
uçuyor: fly
kaçındınız: you avoid
isterdim: i would like to
tutun: tobacco
köpük: foam
söyledim: i told
söyledin: you said
konuğumuz: our guest
kaburganın: the ribs
şans: chance
çıkaracağımı: i will remove
Çık: exit
karısı: his wife
gözde: favorite
arabi: the interface
çocuğumuzu: our child
saldıracağız: we will attack
diyarlarda: in the realm
tutmalı: should keep
şerefi: honor
göndereceğini: would send
yol: way
yok: no
Üstünüzdeki: your body
sınırlara: boundaries
Şahzade'yi: the şahzade
kararlı: determined
söylerse: if you say
sınava: exam
günleri: days
açtığımda: when i opened
dönemden: the period
işlerine: to work
bitmediğini: end that
seskervan: sound caravan
işlerini: jobs
kısasa: tit
çıkartmıyorsam: can not remove
Çıkar: interest
merkeze: center
çadırımda: in my tent
kurdoğlu'ydu: i kurdoğlu'y
gönderelim: we send
bilmiyorlar: they do not know
tezmiş: theses
değersiz: worthless
kalemleri: items
boynumun: my neck
kısmete: the fortune
mutluluğunu: happiness
boynumuz: our neck
hedefimiz: our goal
saldırırsın: you attack
göçmeyelim: i göçmeyel
açacaktır: will
misali: misali
atlıların: the horsemen
venedikli: venetian
havayı: air
kardeşin: brother
cesurun: the brave
çaresizlik: despair
hazırlanın: prepare
şövalyelerini: the knight
Önümüzdeki: forthcoming
şerefli: honorable
savaşan: fighting
şerefle: honor
özür: apology
yapmamız: we do
anan: mother
anam: my main
öbür: glutton
nöbet: guarding
gördüğümde: i saw
olduğumuz: we have
bey'im: lord
maalesef: unfortunately
haçlılara: the crusaders
peygamber'in: the prophet
nasibimiz: windfall
bilmek: know
inanmaya: believing
bilmen: know
bilmem: i do not know
sürülerimiz: our herd
bilmez: ignorant
çeşitli: various
kuvvet: force
yürürken: walking
açacak: opener
doğruluğunun: accuracy of
ayrılırken: leaving
çözemedim: çözemedim
hastalığı: disease
doğduğunda: when born
kimi: who
çakallar: jackals
saldırmasalardı: they had not attacked
başarı: success
tüccarlığımız: our merchant
kime: to who
büyük: big
saman: shaman
kur'anı: kurani
kışkırtıp: provoking
amcasını: uncle
kesme: cutting
tehdit: threatening
oynadım: i played
alâeddin: alaeddin
ayaklanır: insurgency
kurtarıncaya: was saved to
toya: meeting
kırmaktansa: rather than break
şeyden: the thing
ustad'ın: the ustad
tuzakları: traps
kapıcı: doorman
hızlı: fast
attığı: the horse
diri: alive
girdi: entry
rızasını: consent of the
yerleştiğimizde: when we settled
adıyla: by name
açıkça: clearly
güvercinle: with pigeons
etmelisin: you should
kırıklığından: from disappointment
kaçmayacaksın: you're gonna escape
Öderler: pay
konuşmamız: our talk
bekleyen: expectant
çözmenin: solve
görevlerinde: their duties
kaçıyorlar: they flee
kaybeder: loses
dayandın: you rely
dağları: mountains
anlat: tell
özlemedi: not miss
odasına: room
anlar: moments
kartallarla: with eagle
sarayının: the palace
sıra: desk
yemek: eat
duymamız: we heard
etmiyorum: i do not
hâller: still on
sorunla: with questions
çağlamaz: not the ages
döndüğü: he returned
alametlerini: the signs
yürütmek: carry
piyasasında: market
başıydı: head was
sorunlu: problem
burama: to here
uğraşırken: dealing
ziyaret: visit
duydu: heard
ciddiye: seriously
dişinle: with female
kapatırsak: if we close
kılsın: you make
açarsan: you hungry
gözümün: my sight
geçsin: you now
dış: teeth
sizleri: you are
ilgilenin: interested in
dengesi: balance
namusu: honor
yakalayan: the catch
gasp: extortion
alındığı: taken
İşinde: in business
kişinin: the people
yanmak: burn
aldılar: they took
çatlatacak: to crack
dayanamadı: could not resist
çalımı: strut,
kuşanmalı: girded up
çıkmıştı: had been
ertuğrul'u: ertuðrul of
yaylalardan: the springs
kervanımıza: our caravan
hırsız: thief
gönülsüz: reluctant
bilinmiyor: unknown
akıllı: smart
düşmanları: enemies
hele: hele
erkeğinin: of men
kaldırma: lifting
seninle: with you
ertuğrul'a: ertuðrul to
namusudur: honor is
geçeceksin: you'll pass
toprağını: the earth
tapınakçılar'ın: the templars
kumaştan: fabrics
aykız: aykız
çalışıyorsun: are you trying
düşündüğümüzde: when we think about
halime'nin: halime'nin
dağlar: mountains
ederdi: it was
sınırı: limit
gösterecekler: they show
marangoz: carpenter
belki: maybe
ilaçtır: it is a drug
yo: you
Öksürme: cough
ya: ya
governess: governess
istediklerini: they want
ye: eat
elden: from hand
duyulmadığı: unheard
şövalyeydi: what knight
olanları: ones
umursamayarak: ignoring
İhanet: betrayal
tercih: choice
bedeller: costs
âlemini: the world
maksat: purpose
öğrendiler: they learned
hatun: shorty
gömdüğünü: he buried
saklandığı: stored
kanadı: bled
dua: prayer
kıtlık: famine
avucunun: the palm
halep: halep
istenenleri: airports desired
çoktur: is very
yıpranmış: worn
yolun: the road
içirdim: i drink
yolum: my path
hediye: present
yerdeyse: if the place
kurtarmanla: with recovery
uzanırsa: if extend
iyileşirse: if recovered
boşuna: in vain
destek: support
alacakları: receivables
abbasi: abbasi
koşan: running
söylüyor: says
çadırların: the tent
misafirlerimiz: our guests
halledeceğim: i'll take care of
bekle: expect
“her: &quot;each
hazırlanacaksın: will you be prepared
satacak: to buy
uyumuyor: can not sleep
aziz: honor
asi: vaccine
yolluk: travel allowance
gizlediği: that hide
dağılmış: scattered
farkı: difference
övünmeden: without boasting
kısacası: in short
beyinizin: your brain
çıkaydı: come out
anlamış: understand
kaş: eyebrow
tanrı'dır: god is
İzzettin: izzettin
nedir: what
kapat: close
burnumuzda: our nose
sağlam: sturdy
akacak: will flow
maruzatları: submissions are
anavatanımızın: our homeland
düşer: falls
düşen: falling
kürdoğlu'ydun: you kürdoğlu'y
sağlar: provides
gâvurlar: infidels
Şeyh: sheikh
yapabileceğinizi: to do
faydalanmaya: benefit to
baksana: heigh
düşe: falls
gönüllerimizi: our hearts
selcan'sam: i selcan'sa
gerekir: must
katiller: killers
ediyorlar: they're
yapabilir: can
alplerime: my alps
kaç: escape
kendinde: himself
alplerimi: alps me
oyunu: game
gözlerin: eyes
gözlerim: my eyes
kervanımızı: our caravan
camii’ndeki: in the mosque
oydu: he was
oyuna: game
korkaklar: cowards
ceviz: walnut
şaşkınlığa: astonishment
imkan: facility
gelenler: arrivals
ağabeyinin: brother
neslim: my generation
yapardık: we do
yapardın: you do
yapardım: i used to do it
üzerinde: over
açıklamanız: your description
cesaretinize: your courage
içip: drinking
aziz’e: saint
şövalyelerinin: knights
karşıya: across
delik: hole
çözmüyorsun: you do not solve
kara: black
bitmeli: should end
günlerin: days
için: for
içim: me
iyiyiz: we are good
kahkahaları: laughter
Öfkeyle: angrily
dinlensin: you relax
arka: back
kardeşinden: his brother
müsaadenizle: with your permission
iyiyim: i'm fine
getireceksin: you will bring
misafiriniz: your guests
yapacağız: we will do
kürdoğlu: kurdoğlu
yerleşmiş: ingrained
babamız: our father
sarhoşlar: drunk
kan: blood
kal: remain
çeyizlik: dowries
obası: tribe is
koruyun: protect
kat: floor
öğrendin: did you learn
öğrendim: i learned
sayısından: number of
öğrendik: we learned
beklemezdim: i did not expect
yapmıştı: he had made
babamın: my fathers
basmaları: the press
aksa: evening
dolaşmaktansa: rather than wander
ellerinle: your hands
aksi: opposite
giovanni'nin: the giovannia
tutacak: handle
kolları: arms
davranıyoruz: we treat
zindanda: in the dungeon
dökmek: pour
Üstadın: ustad
buradan: from here
kimsin: who are you
olmayanla: why not
hançer: dagger
buluşabilir: can meet
gecesi: night
anladı: understood
gözlünün: eyed
toplayacağız: will collect
bardak: glass
döneceğiz: we will return
toplantısı: meeting
kayi'nin: the apricots
misafirimi: my guest
döneceğim: i will come
utanması: shamelessly
sakinleştirmeliyiz: we need to calm down
değerini: value
misafirimizdir: our guests
üzere: in
kaçmaktan: fleeing
dillere: the language
uyarılarıma: my alerts
dilleri: languages
bedel: price
bereketli: fertile
riske: risks
kalede: the castle
esselamunaleyküm: i esselamunaleyk
doktoru: doctor
hayattan: life
önümden: my way
kılıçarslan'ın: the kılıçarslan
gele: came to
kızlarımız: our girls
affetmemi: forgive me
niyetle: faith
vücudunuz: your body
niyetli: intentioned
nifak: faction
kaderimizde: our destiny
hazretleri'nin: his honor
saldırısına: attack on
alalım: let's
vermemeyi: not to
yararınız: your benefits
inkar: denial
beklediğimi: i expect
düşündün: you think
evlatlarımız: our son
engel: obstacle
rahmetullahi: rahmatullāhi
saniye: second
evlatlarımın: my son
fırlamış: has skyrocketed
yoldaşlarım: my comrades
beceriksiz: incompetent
duası: prayer
kargaşanın: the turmoil
kalbin: your heart
kalbim: my heart
doğmadan: before birth
çalıştığınızı: you work
İyileşecek: to heal
ağlayabileceğim: i can cry
verdiler: they gave
çıkamadık: we can not
getiren: that
geriye: back
buradasın: you are here
bakıyor: looking
kehanetlerin: of prophecy
ölümlerinin: deaths
yargılanabileceği: be prosecuted
yazar: author
ulaşmadan: before reaching
konuşacak: to talk
tedavi: treatment
endişeleniyorsun: you worry
içimi: smoking
zannediyorsunuz: you think
atıfta: reference
boylansın: get sorted
kıldın: you make
mutluluğum: my happiness
mutluluğun: happiness
o'ndandır: he is from
koparıp: plucked
akşam: evening
ordumu: my army
getirdi: brought
vereceğim: i will give
arkadaşını: friend
sokma: insertion
boy: size
kalır: stays
yapabilirler: they can do
kalın: thick
sözümüz: our promise
babamızın: our father
yapanların: those who
leşleri: carcasses
Şehzadem: my prince
alplerimin: my alps
iyi: good
sizin: your
zorluk: difficulty
halime'ye: to halime
zulmü: persecution
halime'yi: halime'yi
duyduğumda: i heard
cehennemin: hell
sönmez: inextinguishable
görmedi: he did not see
muvaffak: successful
yuvalanmalarına: they nest
doğumundan: from birth
hazmetmem: i can not digest
arasındaki: between
etmeyeceğiz: we will not
sonla: ending
tüccardır: and traders
haddini: inordinate
çiğnersen: if you break
kurbanoğlu: kurbanoğlu
emanet: deposit
mallarını: their goods
oğlunla: with son
mutluluğumuz: our happiness
etmeyeceğim: i will not
diyeceğimi: to say
insanların: peoples
heryerde: everywhere
korkmasın: do not be afraid
değerliymiş: it was the value
arkadaşlık: friendship
temizle: clean
feda: sacrifice
sağır: deaf
duyacak: will hear
bacımın: my sisters
kışlada: the barracks
gökten: heaven
ihsan: beneficence
buyurun: help yourself
konuştuğunda: when he spoke
gittikten: you go
bakışları: glances
yüzleştin: you face
meydanlarına: challenge the
isteyecek: to ask
güneşe: the sun
Şöyle: as
bey'in: brain
İstemiyorum: i do not want
hükmedecek: will rule
taşıyamayacağın: can not move
güneşi: the sun
toydaki: the toy
kuytuda: nook
kolay: easy
tapınakçılardan: the templars
eldeki: available
kardeşlerine: brothers
gözlerimin: my eyes
halimize: our state
enikmiş: puppies have
bilgilendirmek: to inform
gökçe: gökçe
kırpmadan: without cropping
eğer: if
bütün: all
yerleşebiliriz: we can settle
kapatırlar: they close
diyorlar: they say
dundar: dundar
başa: head
arkadaşlarım: my friends
rahim: uterus
endişelendiren: worries
evlatlarım: my son
önemlisin: you're important
zamanı: the time
ricasını: ask
dürüst: honest
söyler: tell
başkalarının: others
kokusunu: the smell
eee: eee
eğleşmek: to eğleş
etmezse: does not
şişelere: the bottle
yola: way
emmi: emmi
yolu: way
emirliği: emirates
gücünde: power
düşmediği: the fall
sahabettin'in: the şahabettin
atlattık: we have survived
sanırsın: wouldst
bırakamayız: we can not leave
dadanır: haunt is
görünüyorsunuz: you seem
İzin: permission
gözlerinizi: your eyes
bulaştırdıklarında: when they infect
demircisidir: blacksmith
korurlar: they protect
söylesene: tell me
önemlisi: important
girelim: let's go
dünyada: in the world
otağdan: the tent
vakitte: in time
devletler: states
veriyorsunuz: you give
sokmak: insert
kar: snow
düşünse: although fall
vatanımızda: homeland
topraklarımızda: our soil
idi: was
seviyorum: i love
gerekenleri: they should
koyabiliriz: we can put
zamana: time
altından: under
edersek: if we
kayis: strap
olurken: while
amcacığım: i amcacıg
biliyorsan: you know
neredeyse: almost
hristiyan: christian
biliyorsak: we know
söylemesi: tell
korunaklı: sheltered
hallederim: i got
mahvetti: ruined
hizmetçisiyim: maid
olduran: olduren
papa'da: the pope
aklınca: his own mind
dilediğiniz: you wish
emrine: to order
güvenmen: do not trust
keşke: if only
aptallara: foolish
emrini: warrant
ellerde: hands
kalmayacak: will remain
nefret: hate
süredir: time is
yasakladım: i forbade
ayır: reserve
sokalım: i sokal
kızlarımızdan: our daughter
selam: hello
kardeşi: brother
bölünecekti: would divide
başı: head
iyileşmişti: he had healed
Şarkı: song
hazırsın: get ready
karışma: mixing
çalıştığı: it works
yerimi: bookmark
edeceğini: will be
yayını: broadcasting
metali: metal
biliyor: he knows
tedirgin: uneasy
yakamdan: my neck
inci: pearl
ödeyecekler: pay for
askerlerimizin: our soldiers
süzüleceksin: you're gonna filtered
göreceksin: you will see
darda: dart
götürürken: taking the
naz: affectation
taşların: stone
saldırmana: attack the
Çocuklarım: my children
torunlarını: their grandchildren
ölümcül: fatal
yakar: burns
koruyamadık: koruyamadık
yakan: burning
koruyamadım: i could not protect
taşla: stones
koru: grove
e: to
sözüdür: promise is
bitmek: end
olmazdı: i would not
istemedim: i did not want
istemedik: we did not want
kabilemizden: our tribe
kışlağımız: our quarters of
ayaklar: feet
baskın: raid
dilini: language of
götürüyordun: taking you
Şükür: thank god
çalan: ringing
Üstüne: over
anadolu'dan: from anatolia
insanlarla: people
tepesi'nin: the hill is
ameer: ameer
gönderildi: sent
vardığında: when there
fedakârlığa: sacrifices to
istiyorsanız: if you want
zahmet: bother
hür: free
sevmiyor: does not love
ustamın: my master
hayırlısı: hayýrlýsý
temasta: contact
kâfirlerinin: infidels
görülecek: attractions
ateşini: fire
namusunuzdur: you're namur
allahaısmarladık: good bye
halime'de: halime'de
olan: one
buluruz: we find
karşılama: welcome
dokunursanız: if you tap
düştüysek: if we fall
genç: young
istirahate: rest in
sopunu: the sop
rahmetli: late
elinde: in your hand
duayla: prayer
olmayan: non
dünyayı: the world
ayyubi: the ayyub
elçilik: embassy
koymuş: put
damadın: the groom
bastırma: pastrami
gibiydin: would you like
benimle: with me
avını: its prey
uğraşıyoruz: we are trying
getirmek: to bring
bırakarak: leaving
kaçacaklardı: they fled
yanmış: burned
şehzadeler: princes
evlat: child
boşver: never mind
evleniyor: getting married
üstümüze: upon us
düğününü: wedding
kanamayı: bleeding
çift: double
dokunmuyor: do not touch
halledebildin: could care
Şu: that
yararlanmaya: exploit
hazinesi: treasury
çeyiz: dowry
çaldılar: they stole
gene: again
şeyimiz: have nothing
kurtaran: saving
mızrak: spear
mühlet: respite
tanrıya: god
sormayacak: will ask
kilim: rug
beyler’den: from beylerce
bileceğim: how do i know
çatlasak: çatlasak
ailene: family
çıkarsa: if
obamızda: tribe us
eşhedü: i ashhado
beyliği: principality
olasılığı: possibility of
aileni: family
kabuslar: nightmares
başıma: my head
korudunuz: protect you
hayata: to life
özledim: i missed
üstümüzden: over us
hayati: vital
savaşıyor: fight
ailesinin: the family
ilişkiyi: relationship
nedenleri: reasons
hayvan: animal
yüreği: heart
yakmasın: you're burning
fetheder: conquer
suçlu: guilty
yananı: burning
ekibimiz: our team
muhafızlarından: the guard
ölüme: to death
kararı: decision
his: feeling
bulabilir: find
boydansınız: you boydans
yakalayın: catch
oturuyoruz: we are sitting
kıyılara: to the coast
saldık: we released
varmasın: you arrive
kürdoğlu'ya: kurdoğlu to
baskılara: to pressure
ballandıra: ballandıra
vardı: it had
eyerlerini: the saddle
dünyaya: to the earth
başarırsak: if we succeed
eşkıyalığın: the banditry
ömrüme: my life
hemen: immediately
Çadırda: canvas
fark: difference
rüzgar: wind
sultanı: sultana
düşmüşken: inside his
boyunun: neck
bugün: today
nerededir: where is
edilmez: will not be
esma’nın: the eye &amp; face
ayrılmasına: separation
avına: hunt
gamlı: mopish
kesik: incision
delirmiştir: it was crazy
gidiyorum: i'm going
muayenesini: the examination
kesin: exact
koyma: do not put
ödeyemeyiz: can not pay
beyi'nde: in the brain
vizier: vizier
üşütmesin: masia cold
gülistanlık: dory
tarladayız: we tarlad
zararla: loss
tesellimiz: our consolation
koydular: they put
takas: swap
aykız’ım: i aykız
işten: fired
adalet: justice
yerleştir: place
istediler: they wanted
başlatmalısınız: you must start
yaranın: wound
görmeliyiz: we need to see
dolanma: entanglements
ağladığın: you cry
sene: year
süreceğim: i will
sessizce: quietly
sözüne: promise to
alparslan: alparslan
büyüdüğümde: when i grow up
şenlik: festival
beş: five
bilesin: you even
helal: halal
deyince: deyince
süreceğiz: we will take
bizimki: ours
getiriyorsun: you bring
ettirir: move on
istediğiniz: you want
bıraktım: i left
toy'da: the toy
bıraktık: we left
ettin: you've
ettim: i have
ettik: i've
kurtulmaları: get rid of
kurulu: board
veremem: can not give
alınanlardan: get those
bölgesinde: in
kontluğundan: the county
abimi: my brother
bırakacak: leave
mera: grassland
gönlünü: hearts of
boyu'nun: height of
bilekte: wrist
umudusun: hope you
kaybetmemeliyiz: we can not lose
adamıymış: he was the man
İzinsiz: unauthorized
ulaştıysa: it has reached
girmedik: we enter
babamla: with my dad
götürmeni: to take thani
selçuklu'yu: the seljuks
gelsinler: they will come
uçsuz: pointless
sözünü: promise
pazarda: market
halep'imize: our aleppo
komutan: commander
galibin: the winners
körelsin: you are blunted
yorulduk: we are tired
yoruldum: i'm tired
pazardaki: the market
şükürler: thank
istemiyorum: i do not want
olduğumuzu: we are
işinde: business
böylesi: such
istemiyoruz: we do not want
gitmenizi: you go
gösterdin: show you
safta: pure
ormanda: in the woods
suyu: water
titus'un: the titus
biliyordum: i knew
melekleri: angels
suya: water
görüşün: the opinions
tepesi'ndeki: the hill is
beklermiş: he expected
kayıp: lost
kimliklerini: their identity
uyaran: stimulant
akdeniz'de: in mediterranean
yapmışız: we have done
cennetteki: heaven
çözümü: solutions
askerler: soldiers
ordularına: their armies
düşünsün: you think
hâlimiz: our carpet
biliyorum: i know
Ömer: umar
biliyoruz: we know
öğleden: afternoon
seviyeye: levels
ertuğrul'dan: from ertuðrul
uğraşmam: i did not bother
çiğnersiniz: you chew
sandıklarda: in polls
beh: beaker
ben: i
berekatühü: the berekatüh
arkadaş: friend
yaklaş: come closer
etine: flesh
bey: bey
kalkmayı: up to
gördüğü: sees
henüz: yet
hissetmemiştim: i feel
duyması: hear
başında: early
olunan: when the
paylaştınız: you shared
haydan: hayden
kalacağız: we will stay
bari: at least
azrail'i: the angel of death
zorundasın: you have to
ineceğini: in that
eşkıyasının: the bandit
bildireceksin: you're gonna report
abla: older sister
cansız: lifeless
mucizesi: miracle
vereceği: will give
hizmetçisiymişim: maid uymuşum
gavurunun: of infidels
halime: halime
kurur: dry
üzerimize: upon us
elinden: hand from
ayağına: foot
İzninizi: your permission
fikir: idea
çağırmadan: calling
elçi: envoy
döndün: you're back
döndüm: i returned
düşündüm: i thought
saklamak: hide
çadırından: the tent
dönmüş: frozen
oldukları: they are
titrinden: the titre
çocuğuma: my child
kocasına: husband
hadi: come on
yerinden: displaced
gelmelisin: you should come
adham: i adham
boynum: my neck
yük: load
nereye: where
hiçbirimiz: none of us
sızdılar: burrowed
Üstelik: moreover
kadarıyla: as far as
hükümetin: the government
yüz: face
duyduğunu: heard
yüzer: floating
görünür: visible
bilmeyen: unknowing
sırdaşım: my confidant
kalabalıklaştı: busier
tehlikeye: danger
savaştığını: that war
tehlikeyi: danger
hayme'nin: the khaimah
gidemezük: gidemezük
kanınızı: your blood
kalmıştır: remained
adı: first name
benzer: similar
yoldan: the road
başlama: start
oradan: from there
sarı: yellow
kevaşesi: the skank
kalbinde: in the heart
karavanda: the caravan
uzakta: away
yakalamaya: capture
endişelendik: we worry
emniyetim: my safety
gibisi: nothing like
zamandan: time
gelmiş: have come
demeyecektin: saying,
yeğenimi: nephew
vesveselere: whispers to
vesveseleri: specter of
ameer'e: ameera
asıl: noble
elbet: certainly
çelmesine: trip to
cesursun: you're brave
bahtın: the baht
karşılanacaktık: would be met
aleykümselam: i aleykümselam
türkmenler: türkmenler
haydutlar: bandits
sinirlenmezsin: you dont get angry
kez: times
çıkaracak: will remove
konuşulacak: to talk
kes: cut
tarikatımızın: our sect
ağlama: cry
çıkarabilirsek: we can get
zindandaki: the dungeon
içerde: inside
şüphelenmiş: have suspected
gittiniz: you go
öldürürüm: i will kill
harezmşahlarla: with harezmshah
gidilir: go to
dururum: i stand
aşkına: sake
dururuz: we stand
pusattan: from armor of
kalplerimiz: our hearts
sari: yellow
daĞlari: mountains
karargâhından: from headquarters
yap: do
yas: age
yar: tomorrow
gerekiyordu: it was supposed
cenk: epic war
yan: side
sesimizi: our voice
acın: open
anlaması: understanding
hayme'm: i khaimah
saru: sarumaki
Şah’ımızın: our şah'ı
atınıza: throw away
yolunuzu: your way
korktuğumuzu: we fear
kocasını: husband
yolunuza: your way
sarayların: palaces
kölelikten: from slavery
otu: weed
yoldaş: comrade
Ünvanlarını: the title
mezar: tomb
bekçi: guard
sevginizle: your love
miyim: can i
kalbiniz: your heart
delilik: madness
deme: do not say
ekin: crop
zamanla: in time
ayaklarım: my feet
yoldaşım: my comrades
etmesine: to the
bilmezmişiz: we know we're
küçüklüğünden: smaller than
başlayabiliriz: we can start
ekip: team
içimde: inside
etmesini: to the
bekliyordum: i was expecting
ayrılmak: leave
sarayımıza: there palace
eylemediysek: eyle were unable
meselesiydi: it was a matter
yatıramazsın: you're not puttin
evvelden: aforetime
değilse: if not
Çocuklar: children
uyandım: i woke up
gizli: hidden
yeğeninin: nephew
kazanın: earn
savaşmaya: to fight
verirken: while
hünerinize: your prowess
baykuş: owl
anlatmak: tell
uğramışlardı: they have suffered
nasıldı: how was it
hikayelerini: stories
toprağımız: our land
daim: recycle
dönmesini: return the
dönmesine: return to
hı: what
öldürün: kill
katillersin: you killer
bundandır: is that
40: 40
yoktur: there is no
çoluk: offspring
tezekler: dung for
dair: about
piyon: pawn
söyleyen: said
rükneddin'in: the rükneddin
amacımıza: our objectives
olabilecek: will be
süleyman'ın: solomon
olduğunuz: you
bizde: us
mahkumsunuzdur: you're doomed
haklıydı: he was right
yoldayız: we're on
kimlerdensiniz: you kimlerdens
gökte: in the sky
sabaha: to morning
gözlerinle: your eyes
unutursa: if you forget
okunmaz: unreadable
mezarında: in his grave
konuştu: spoke
gücümde: my strength
sebebin: the reason
burası: here
atabiliyorum: i can throw
mümkün: possible
obada: obada
işi: heat
yardımı: help
işe: if
arkasındaki: behind
gerdiğini: that stretch
istedik: we wanted
haberle: news
yaralanmış: wounded
ait”: owned &quot;
İçeride: inside
hayırlısıyla: hayırlısıyla
körükleyelim: i körükleyel
nedense: for some reason
köşelere: the corner
dönmekte: rotates
pahalısını: the expensive
ezerim: i will crush
acıları: the pain
düşünmene: thinking to
ziyaretçilerimiz: our visitors
kışkırtan: gingery
yollarda: on the road
beceremediğin: you failed
inancımda: my faith
mesken: domicile
anlatıp: telling
herhangi: any
müsaade: permit
süre: time
kuraklığın: drought
savurdu: slashed
bilmeden: without knowing
vereceğiz: i'll give
olabiliriz: we can be
kararlar: decisions
içime: içime
küçücük: tiny
ünlü: famous
öldürebilirdik: could kill
söndürmemiz: our fighting
dönüşü: return
tanrım: my god
girmediniz: you did not enter
mağaraya: cave
bıçaklandı: stabbed
bekliyorlar: they're waiting for
İhtiraslı: passionate
sönse: although sö
yazarıyım: i'm a writer
ölmem: die
kimdi: who
ölmek: die
toplu: collective
hz: hz
dinlemedin: you listen to
adım: step
adın: your name
çıkartalım: draw
ha: ha
akçe: fund
he: h
oğlunsam: human son
itin: push
dilinden: the language
mührü: seal
pusat: pusat
aslan: lion
öteki: other
çıktık: we set
zannediyordum: i thought
mevki: position
çıktın: the output
edeceksin: you're going
yıllardır: for years
emeğini: labor
bitap: exhausted
hastalığına: disease
acizler: incapable
erim: range
saniyede: second
kulakların: the ears
yanıyor: on fire
tedirgindir: is anxious
getireceğime: i will bring
tarafa: party
gerektiğini: ought
getireceğimi: i will bring
sözümüzden: our promise
herif: guy
lokmasını: the bite
sayısız: countless
obasında: in tribe
beklemesini: wait for the
tepesi'ne: hill
altın: gold
kapının: door
saladin: saladin
çadıra: tent
pusatlarımızı: our pusat
kervanımız: our caravan
imana: faith in
göster: show
Ölümü: death
kötüdür: it is bad
ömür: life
vazife: mission
kesinlikle: exactly
olunca: when
obaya: tribe to
kurtardığın: you saved
koparıyorsun: you're tearing
arınmanın: purification mani
yapayım: shall i
küstahlıklarını: the arrogance
sözünden: his promise
gelirler: revenues
neymiş: neymiş
oyuyoruz: we gouging
hayvanlarımız: our animals
kaçacağız: we'll take it
bittiği: ended the
kumaş: fabric
bekleyelim: wait
bazen: sometimes
uzaklaşıyor: recedes
kişidir: he is a person
sülalemizi: our family
kayılara: shifted away
sözleriniz: your words
aladdin'i: the aladdin
tarafınızdan: by you
takdirine: to appreciate
umarım: i hope
bilemeyiz: we do not know
tepedeki: apical
büyürken: growing up
efendimi: sir
tutumunuz: your attitude
gönlün: the hearts
gönlüm: my heart
olmasa: although
yaylak: pasture
olmazmış: it has not
eğitimli: educated
ellerimle: my hands
evvel: before
bilmesini: know
bırakmışlar: left on
tacıdır: crown is
ustad'ı: the ustad
çakacak: to age
dayanıyor: it is based
ney: what
koparmaktan: break away
maverick: maverick
düğününüz: your wedding
yıkarım: i wash
varalım: let 's reach
uğursuz: sinister
bilmeni: know
inançları: beliefs
haçlıyı: crusader
boyun: neck
elimiz: our hands
endişelenmeden: without worrying
göğü: sky
gözlü: eyed
derini: deep
ovanın: the plains
tüccara: merchant
koynuna: bosom
zamanını: time
iyileşirken: recovered
ümit: hope
şifa: healing
shahzades'den: from shahzades'
sevgi: love
sağlık: health
üstünde: on
yapılabilecekleri: what can be done
yaycının: the radiating
çekerek: pull
titus'dan: from titus'
eğleniyoruz: we are having fun
bulutları: clouds
Şahinler’in: the sahinler
şifasını: healing the
basıp: press
aynısını: the same
ağacı: tree
obayı: tribe is
toplanacak: will be collected
kaçmalarına: escape the
Ölüm: death
esirgediği: the merciful
büyüttükçe: business grows
illallah: nuts
huzurunu: peace
kimsiniz: who are you
çözebilirim: i can solve
aqsa: aqsa
belliydi: it was obvious
alp'e: to alp
çekilmeden: withdrawal
onun: her
gönderemem: i can not send
konuşmalıyız: we need to talk
yaptığım: i made
Üstad: master
çare: resort
görmesi: see
kaybınız: your loss
kölem: i slaves
konuşmalıyım: i need to talk
Üstat: virtuoso
olabilmek: to be
ödemek: pay
toydan: from meeting
düşürdün: dropped
sıradaki: next
ülkesini: country
öğrenmeye: learning
yetiştirenler: who grow
yiğit'in: the valiant
benziyor: it looks like
yiğit'im: spunky
öğrenmeyi: learning
kabus: nightmare
kabul: accept
lütfen: please
yüreğimi: my heart
mülk: property
alaaddin: aladdin
olmadığın: you're not
olmadığım: i'm not
yapmıyordum: skied
sağlıklı: healthy
olması: being
acını: pain
bitmiş: finished
kaşık: groin
öldürürlerdi: they killed
destekle: support
yayından: the publication
bağırma: do not scream
kabiledir: tribe
hayvanlara: animals
gebertmeyeyim: should not i kill
çeker: are
çeken: suffering
kemiren: gnawing
baskı: printing
odaklandı: focused
palyaçolamayı: i can not palyaçol
kontrolümü: control my
çözeceğiz: we will solve
eğleyip: eğleyip
toyun: toy
gelinimden: my bride
dün: yesterday
kılıçlarla: with sword
ayrılalım: i split
yüzüne: face
kudüs'ü: is jerusalem
açtınız: you open
kabulümüzdür: our acceptance
durur: stops
durup: stop
durun: stay
durum: status
senin: your
suçlamaları: accusations
oynuyorlar: they are playing
eşyası: goods
çadırlar: tents
hayalini: dream
kılıçlarımız: our swords
bıraktığında: when he left
yollamış: he sent
doğduğumuz: we were born
kılığa: dressed as
Şahzade'nin: the şahzade
isem: if this is
olaylara: events
bulaştığın: you're infected
emirinin: of orders
lowlife'ı: the lowlife
isteyenler: those who want
güçlü: strong
fırsatı: opportunity
bedenlerini: their bodies
lanetini: the curse
yollayacağım: i'll send
zenginliğin: wealth
günahını: sin
haklıysa: is right
pençesine: paw
istemiyormuş: he did not want
bakışını: overview of the
yerine: instead
dostum: my friend
Çobanlarla: with the shepherds
omuzlarına: their shoulders
hakkım: right
fırlatma: launching
atlarımızı: our horses
çıbandan: the boils
şövalye: knight
kızımızla: our daughter
güveniyor: trust
bacağı: leg
ederse: if the
kudüs'e: to jerusalem
yüzünü: his face
sormuş: he asked
moğollardan: the mongols
gömdüm: i buried
yakmak: burn
dururmuş: he stops
anlamazlar: they do not understand
kayis’e: strap on
bunlardan: of them
erinin: erin
yaparsa: if you do
umut: hope
kayis’i: apricot
sökmeyi: disassemble
fatiha: fatiha
olsun: get
yapmazsın: you do not
gündoğdu'yla: gündoğdu'yl to
leila: leila
ordularınızın: your army
geçireceksin: you're gonna spend
sabrın: patience
pusatları: armor of
tamgamız: our tamga
ise: if
kurtulan: survivor
uyumaya: to sleep
decency: decency
kapanma: closing
kalırsınız: you will
elhamdülillahi: alhamdulillah the
uğrayanlara: have suffered
görmeni: see the
avla: hunt
rabb'im: my god
düş: shower
yapmalıyız: we have to do
bedeli: fee
çiftliğin: the farm
yüreğimde: my heart
halledelim: let's get
yapmalıyım: i should do
arttırmanı: new arttırmanı
söylerken: singing
kuralım: my rule
kudüs'ümüzün: our kudüs'ü
tanrının: the gods
günlerdir: for days
büyütüyorsun: you magnify
odanızdaki: your room
kayis'i: apricot
kayis'e: strap on
ailemi: my family
toyumuz: our toyukan
değmesin: get a touch
bıçak: knife
inşa: construction
kalpler: hearts
toparlayamaz: not gather
aittir: it belongs
eyer: saddle
getirecekler: will bring
toprakları: territory
düşünüyorlar: they think
hanginiz: which of you
koyacak: to put
edilebilir: can be
ihlal: breach
getiriyor: brings
gitsem: gitsem
gelmesin: do not get
sıkıntılar: difficulties
güvenmenizi: trust your
çıkmayacak: will come
isterseniz: as you want
sarmayın: winding
mario: mario
yutabiliyorum: i can swallow
almalı: should take
yapacağımı: to do
ateşe: fire
alınırken: getting
vekâlet: proxy
İlahi: divine
İçeriden: within
ölürüm: i will be
yediğimizden: we eat
ölürüz: we die
çıkarttım: i removed
görevlerde: the task
sallaya: waved
velakin: velakin
saklamamanı: new storage
gücüm: power
boyası: paint
delikanlı: lad
hepsinin: all of them
çeki: checks
yahya: yahya
karanlık: dark
kalmanız: your stay
acılı: spicy
görünce: seeing
güveneceğiz: we trust
belayı: scourge
deyip: saying,
yoldaşımız: our comrade
ağırlamak: entertain
bıraktığı: he left
bar: bar
bas: top
oturacak: seats
uyulur: complied
dosta: friendly
yapıyorum: i'm doing
satıcıların: sellers
geçiyor: passing
süleyman'a: solomon
asistanım: my assistant
oyalanmayın: the diversion
şaşırmıştı: i was shocked
girmeye: enter
ediyorsunuz: curious
gelse: overtakes
destanlarını: their epic
veren: that
tahta: board
alayını: procession
takdiri: if the
iş: business
misafiridir: guest is
etkililer: effective on
gözlerimden: my eyes
görmeyecek: will see
rahibe: nun
yılan: snake
geliyordum: i was coming
korumayı: protection
hesaplayabilirim: i calculate
bozmak: disrupt
anlatmışken: have described the
açtığı: open the
azat: release
kararını: decision
misafirimiz: our guest
nabzını: pulse
canı: villain
kurtlar: wolves
kıyametimiz: our doom
bitiriyorsun: you finish
söyle: tell
falan: like
isteyebileceğini: you might want
verilmelidir: should be given
hemfikir: agreed
cehennem: hell
zindanı: dungeon
geldim: i came
gökçe'yle: gökçe'yl to
olalım: let's
İsmim: my name
saklamazsanız: if you do not store
Şahımızı: shah us
efendisi: lord
karındaşına: karındaş to
iç: internal
yağmuru: rain
ayak: foot
nazlı: spoiled
bittiğinde: when finished
gardiyanlar: guards
şu: that
sürüsü: herd
haritadır: is the map
alakalı: relevant
varma: arrival
aşağıya: down
muyum: am i
dokunulmazdı: he was touched
baş: top
işlerle: work with
ağzımdan: my mouth
edebimizle: our literary
gebertmedik: we did not kill
kemerinin: the belt
olanlar: those
alplerinle: with alps
bilmiyor: he does not know
görüyorsunuz: you see
tane: piece
yatırılan: deposited
say: count
sözlerinden: words from
zorluklara: hardships
uğultu: buzzing
insafına: mercy
meltem: breeze
avın: hunting
tanıyan: that
sımsıkı: fast
dileyecek: will wish
it: it
cani: villain
koruyacaktı: would protect
yıldır: years
imzalı: signed
sultanım: sultan
topraklarımıza: our land
çıplak: naked
Çıktı: output
komutanımız: our command
kardeşini: brother
sızan: leaky
korkmuştu: he was afraid
belli: certain
çağrıda: call
gidermek: resolve
uyumamışsın: you sleep
dipsiz: bottomless
vaktim: my time
istihbarat: intelligence
emretmişsiniz: you ordered
atılan: discarded
ovalardan: the plains
geçilir: is passed
vuramazdı: he could shoot
kir: dirt
gitmemiz: to go
binin: thousand
dediğinin: you say
tahtı: throne
süleyman'ı: solomon
ordum: army
başımıza: our heads
kin: hatred
kim: who
saldırabildiğine: could make attack
olabilirler: can
dediğiniz: you also
sizsiniz: you're
yüzlerine: their faces
ölümüm: my death
ellerinde: their hands
boyayı: paint
sallar: shakes
ortak: partner
eyleyeceğiz: we will act
yem: forage
çıbanla: it boils
çıkmadığında: when leaving
versek: and herzegovina
başlayacağından: will start
katılacağım: i will attend
yakına: closer
soyumuzuza: soyumuzuz to
ezebilirim: can crush
versem: and i
kurtulamazsın: get rid of
tepsiyi: tray
yapmış: made
yer: place
geçeriz: we pass
tutmuştu: he had kept
olduğumu: i have
töreymiş: somethin 'ceremony
fedakarlığı: sacrifice
kalma: stay
artık: no longer
başkanı: chairman
olabilirsin: you can be
yarının: tomorrow
başlar: starts
gözlerimmiş: observed erummuş
koyuna: sheep
selamettir: salvation
hayvanlarının: animals
karşılaştığım: i encountered
yardımıyla: with the aid of
yaslanıp: lean
düğününüzü: your wedding
yolunuz: your way
işledim: operating
işledik: we handle
yıldırım: lightning
perdeleri: curtains
kırılmazsınız: you kırılmazs
kanlarınızı: your blood
vazgeçmesi: give up
şövalyeleri: knights
görebilen: sighted
duymaz: not hear
kudurmuş: rabid
itlik: equality
eken: eken
öldürmem: kill
öldürmek: kill
kazıyarak: scrape
akıyla: whites
göçeceğimiz: we migrated
duymak: hear
ağa'nın: the network
sürmeyi: riding
iyice: thoroughly
götürdü: he took
üçümüz: three of us
çıkarsanız: if you go
veda: farewell
Şeref: honor
ilerledikçe: progressively
sayende: thanks
yaşıyorsa: if he is experiencing
abla'yı: sister
dönersin: you can go
izleyeceğiz: we will follow
dünya: world
bolu: divided
doyurmak: feed
bakarsın: you look
kokusu: smell
siyah: black
dilim: slice
eftelya: eftelya
dilin: the language
konuşulmakta: it is spoken
büyüttün: you raised
ihtiyacım: i need
ihtiyacın: your need
planlıyorsun: you plan
gerçeklik: reality
yüzlüm: yüzlüm
gidebilirsiniz: you can go
doğum: birth
eksik: minus
canavarlaşmış: canavarlaş have
sırra: the secret to
boğazımda: my throat
dündar: dündar
kırbaç: whip
saray: palace
kılıçtan: the sword
öfkelenmezsin: you öfkelenmez
yediririm: i will feed
meçhul: unknown
söyleyin: tell
verecek: will give
askerlerimi: my soldier
davranmamalı: should not act
incelerdi: he studied
yıkmıyorsam: can not destroy
yoğrulmuştur: kneaded
koruduklarını: they protect
söyleyeceğim: i will say
ölümüne: to death
beri: since
sırası: sequence
göndereceğin: will send
silahımı: my gun
dilerim: i wish
yapmayacak: will not do
yusuf'u: joseph and
koymalısın: you should put
anlayabilirsiniz: you can understand
ovalarda: the plains
kullandınız: you use
sarışın: blonde
geçerse: passes
görmeli: should see
anlayacaksın: you will understand
bitenle: ending it
hâlde: in case
kaldır: remove
kilimhanedeki: in kilimhane
dediğini: it also
bahsetme: mention
dualar: prayers
getirdik: we brought
ana'm: my main
kaldım: i stayed
kaldın: you're
duymaya: to hear
kaldık: we're
başlarlar: they start
gözünüz: your eyes
duyduğunda: when you hear
bayıl: love
söylüyordu: he says
aklınızdan: your mind
sonuç: result
ekinlerimize: our crops
gözünün: the eye
çek: check
yazdığı: he wrote
giremezlerdi: they would enter
agabey: brother
çarpacaktı: would multiply
gördüğünde: when he saw
işkence: torture
uluları;: exalted;
endişelenirdim: i'd be worried
ondan: from him
esiyor: blowing
getirebiliyorsan: if you can bring
dağlardaydı: it was in the mountains
göremeyecek: to see
köpeklerini: the dog
çatırdıyor: crackling
aldığı: receives
söylemeyeceksin: you will not tell
ilahi: divine
durumda: in the case
yapamayız: we can not do
ilahe: goddess
olabileceğin: will be
büyüt: enlarge
aklımızı: our minds
iyileşebilir: ameliorative
hazırsa: if you're ready
kalmamalı: should remain
avratlar: avrat on
edebilecek: that can
tahttan: from the throne
balkonda: on the balcony
kabilede: the tribe
yaşlılığından: the old age
bebeler: bebeler
Şunları: include the
dil: language
beceriksizliğini: the incompetence
korusun: bless
dönen: rotating
dik: perpendicular
yapamıyorum: i can not
kuzularınızı: the lamb
majesteleri'nin: the majesty
başınızı: your head
dönmeliyim: i have to go
olursan: the matter
olursam: if i
sürede: time
zevkine: enjoy the
kudurup: kudurup
huzursuz: restless
ayı: bear
kutsal: sacred
duruşma: hearing
moralini: morale
sarayı'nda: the palace
abla'nın: sister
ruh: spirit
edecektir: you will
yeğenimizi: our nephew
müsün: mucin
fakih: scribe
halimeleri: their state
vizierim: i vizier
halimelere: state malara
rum: greek
görmez: does not see
çöz: solve
arkasından: behind
hainler: traitors
görmem: i see
çöp: garbage
dandanaqan: the dandanaq
görmek: see
doğuracaksınız: you will give birth
birliğin: the unity
deriz: we also
bırakmayacak: will not leave
fena: bad
derin: deep
derim: i say
basacak: will press
şartım: i must
insan: human
ayartmak: seduce
insaf: mercy
bol: plenty
yaşla: age
unutmayın: remember
söylerdi: he said
gelmiyorum: i'm not going
aldatma: deception
durdurabilirsek: can stop
istiyormuş: would he
kayan: sliding
tanıklardır: are witnesses
özlüyorduk: we miss
demiştin: you said
duyduğum: i've heard
muhafızlarla: guards with
duyduğun: you heard
Şeyhim: my sheikh
beklemekteyiz: we expect
yorgunsun: you are tired
öğretmendir: teachers are
başınıza: your head
ölmeden: he died
savaşlar: wars
gelmedi: did not come
müslüman: muslim
boynumuzun: boynumuzun
denemelerini: the trial
yazı: article
adamla: man
velet: brat
yargı: judgment
yakala: catch
açan: opens
hisli: sentient
yiğidi: valiant
askerden: from military
ulu: great
katalanlar: catalans
gelmenize: come to your
aziz'in: the honors
amcamı: my uncle
dökülecek: be poured
devletin: the state
kendinle: your own
ilgilenmem: i'm not interested
tezgâhım: i stand
gururla: proudly
okyanustan: from the ocean
karanlığında: in the dark
önemi: the importance
anlayacaktır: will understand
ertuğrul’un: the ertuðrul
aykiz: aykiz
asma: suspended
yetinmeyip: not satisfied
cesurdu: it was brave
borcu: debt
elanora: elanora
yön: direction
kulaklarınızı: your ears
boyu'ndan: height from
düşünmeye: thinking
mat: mat
boş: null
düşünmeyi: thinking
karşımızda: us against
azap: torment
yerlere: place to
eylediysek: if we act
mal: goods
bismillahirrahmanirrahim: bismillahirrahmanirrahim
hassas: sensitive
hapse: jail
kökünden: radically
çarşıda: the bazaar
pisliğin: the filth
moğolların: the mongols
bağışlar: donations
anlarız: we understand
öldürdüler: they killed
arabayı: car
kulak: ear
yöneticilerini: the manager
büyüyecek: will grow
sürtükler: bitches
evlenecektik: going to get married
Çağırdım: i called
rabbi: lord
derken: then
iyisin: you're good
topraklara: the land
kiminle: with whom
şükür: thank god
İktidar: power
gözlerinden: from your eyes
yıldız: star
vurmalılar: percussion
dogan: born
isyanının: of rebellion
saklamıyorsun: do not hide
sırları: secrets
seyredecek: to watch
sadakatini: loyalty
gel: come
Şimdi: now
kavrulmak: broil
zehirlemek: poison
elindeyseler: hand undaysalar
birbirine: each other
nihayet: finally
acırım: i pity
hâlâ: still
yanar: lights
meydanı: square
yeğeninizin: niece
Çığlık: scream
elleri: hands
sağlığını: health
İslam'ın: islam
borcumuz: our debt
lan: man
yaptığımız: we do
yangına: fire
odada: in the room
merhemi: ointment
dökerken: pouring
kötüye: abuse
körükle: blowers
edeceğim: i will make
yıldızlar: stars
yurdumuz: our country
ufak: small
meraklandırmak: ruffle
haydi: come on
bitirenler: finishers
çekil: get out
cevabı: answer
ardından: next
yurt: dorm
rızan: the consent
kabahat: fault
etkilemeye: affect
zehri: poison
çekip: pull
önünde: in front of
kimliği: identity
buluşmamız: our meeting
vurdu: shot
askerlerle: with soldiers
bırakılmıştır: it was left
bakalım: let's see
desteği: support
öfkeli: furious
toprağın: earth
cüzzamlı: lazar
kudüs’ün: the jerusalem
yüzümüzden: our face
eğri: curve
bulaşmadığı: the infection
varacağımız: there will
hakkın: right
yasal: legal
hapsedildiğini: he was imprisoned
çekiyorsun: you pull
kuşa: birds
üşüme: chill
gireceğim: i'm going
gidişi: going to
yazılmış: written
hanedanına: dynasty
uğradık: we've been
uğradım: i was
tattınız: you taste
hamileyken: pregnant
piyonlar: pawns
birlik: unity
gitmelisin: you should go
kilitlenip: locked
sözünün: of promise
bildiğiniz: you know
budalasıyla: the fool
bayılıyorum: bayılıyorum
müsaitse: courtesy of
gerisi: rest
güllük: güllük
kaybetti: lost
gözdağı: intimidation
17: 17
yandım: i burned
zamankinden: ever
vurabilirdim: i could have shot
bulamamaktayız: mostly we do not
yalnızca: only
aramak: call
olmazsa: unless
geldin: you came
delilerle: mad with
geldik: we came
toparlanırım: i recover
bulutlara: the clouds
efendinim: my lord
kurtarmaya: save
bilmeyecek: to know
talip: suitor
ödeyeceğiz: we will pay
buradaki: here
edince: learn by
dinlen: relax
turgut’un: turgut
görüşecekmiş: gonna opinions
müsaadenle: with permission
dağların: mountains
orada: there
2arın: the 2ar
eşkıyasını: the bandit
yangını: fire
umutlarım: i hope
yapabilirim: i can
kesat: slow
beyler: gentlemen
çeviriyorsun: you turn
dededen: dededen
yapabiliriz: we can
görememek: loose sight of
erine: accesses
planımız: our plan
geceden: the night
bakacağımızdan: we will see
bayır: slope
kayıları: boats
tamamlandı: completed
duyduğunuzda: when you hear
halep'in: the halep
hayatta: in life
getirdim: i brought
getirdin: brought
yarasını: wound
sefalar: sefalar
duymasını: hear
takip: follow
hatırlarsın: you remember
otur: sit down
geçmiştir: is history
basıldı: it was published
tutacağız: we will keep
kaygılarınızı: your concerns
dinleyelim: listen
şehzadem: my prince
tapınakçılarla: the templars
kuluna: servant to
evladına: the son
çadırına: the tent
cazgırının: of cazgır
beklemek: wait
tatlım: sweetie
demez: not well
sipariş: order
batacağız: will sink
İftiralar: slanders
pazarında: market
ihmal: neglect
Çakmak: lighter
get: see
baltayla: ax
gez: hindsight
çıkamaz: can not go
içeride: inside
görev: task
ayrılacak: be separated
gören: sighted
tanrı’ya: god
yemin: oath
panikledin: you panicked
melanetlerini: the m.p
atıyor: beats
şüphelendiği: suspect that
peşindedir: is seeking
lokmalarınız: your bite
ayarlayabilirsin: you can adjust
buraya: here
teşkil: pose
dalgalanacak: dalgalanacak
geceler: nights
binmemiz: our riding
bismillah: bismillah
korunuyor: protected
kaçtık: we fled
kaçtım: i escaped
duruşmasına: hearing the
anavatanımız: our homeland
kurduğumuz: we established
ganimet: loot
belirlediği: determined that
neslimiz: our generation
borcumu: my debt
geçti: passed
gardaşlarım: my gardaş
tacir: trader
tut: keep
öder: pays
geç: late
aşiretlere: the tribes
İki: two
zindana: dungeon
sofraya: a table
obamız: our tribe
sebepsiz: causeless
yolda: on the road
tüccar: merchant
bulunmaz: available
obamın: obama's
gitmiyor: do not go
töremiz: our ceremony
getirilecektir: will be
ayılar: bears
günaha: sin
Şunu: the following
ölümüyle: the death
kadınlarından: from women
susun: silence
saklıyor: hiding
götürmen: take bearing
hepimizin: all of us
ensesinde: in the nape
taşkınlık: abundance
bıraksa: let go of
neferi: soldier
gölge: shadow
kutsaması: blessing
kaderim: my destiny
misafirlere: guests
dolanır: is filled
yanımızda: with us
yaşadığınız: you live
misafirleri: guests
Şahsen: personally
söyleriz: we say
felakete: disaster
gelene: from
neşe: joy
geleni: from the
iklimde: climate
ellerimi: my hands
öderken: paying
gider: expense
yardımcın: to help
yardımcım: i help
büyüklüğündeki: in size
giden: outgoing
evladını: the son
İbnü'larabî'nin: the ibnü'larabî'n
çadırını: the tent
yaratmaya: to create
yardan: the yard
vermemize: give us
büyümeye: growth
hazırlanıyorlar: they are preparing
itinin: of it
bilseydim: i knew
kaçıyoruz: kaçıyoruz
sığınır: refuge is
aşmamın: overcome my
duyuldu: was heard
çocuklarımın: my children
pak: pure
kontrolden: control
misafirlerimizle: our guests
mesele: matter
haberleri: news
atından: the horse
Çadırımda: in my tent
jenerik: generic
fırtına: storm
yukarı: up
burayı: here
bakma: do not look
kırık: broken
yıkılmaz: indestructible
yetiştiremezsin: you can not raise
tezgâh: counter
yaktı: burned
koyarken: koyarken
bana: to me
gerekiyormuş: it was supposed
alaaddin'e: alaaddin to
körükleme: fostering
ettiği: watch it
baskılar: prints
germeyi: stretching
seneler: years
isteyince: asks for
sorularıyla: question with
bilinmeyen: unknown
aramaya: in search of
almamalı: should take
nöbetçileri: guards
sınırlarınızda: your border
gelmeyeceğiz: we will come
dönüyoruz: we're going
basma: print
güzelliği: beauty
içi: intra
görelim: see
müşkül: müşkül
okumayı: reading
alacakaranlıkları: twilight of
umurumda: care
kilimhaneye: kilimhane to
şerbetini: the syrup
kurduk: we established
halis: halis
saltanatı: reign
adama: man
İnsanın: human
söylememi: tell me
bamsi: bamsi
kurdun: the wolf
giriyorsun: you are entering
sustu: stopped
devleti'ni: the state
olmuş: dead
geçiriyor: spends
kısıldı: narrowed
sinirlendiren: nervewracking
dolu: full
düşünmezdim: i would think
yatağında: in bed
olduklarını: they are
lokma: bite
yeleği: vest
verdikten: give you
yoruldunuz: tired
geçmişte: in the past
iftihar: boast
otağımızda: our otag
göçemezsek: if we do not migrating
uyulursa: if compliance
çukurun: the pit
partiyi: party
İşlerini: jobs
sesin: sound
gücü: power
aşkı: hanger
halep'te: in halep
sesseni: sound you
neden: why is that
elindeki: in your hand
nefesini: breath
çoktan: already
nefesine: breath
ezdiğini: crush it
yaparlar: they do
çıkamayan: who can not
değil: not
İşini: your job
avlamaya: to hunt
savurduğu: which slashed
saklayan: stores
versin: give
yaşlanıyorum: i'm getting old
midir: is it
kafasını: head
adalete: justice
düşünmelisin: you should consider
bamsı: bamsı
adamı: man
pusuya: ambushed
geçmiş: past
karakterler: characters
selamla: greet
İçeriye: inside
adaleti: justice
kardeşimin: my sibling's
gelmesine: come to
tanık: witness
kurtulmanız: you get rid of
ocağımıza: our quarry
adamdır: man is
dualarımı: my prayers
terbiye: dressage
düşünerek: thinking
ödeyeceğimi: i pay
İslam: islam
kalksın: get up
karavanların: the caravan
dilden: the language
buralarda: here
kalırsak: if we stay
geçirecek: will spend
bey’e: bey
Önemli: important
töreyi: töresi
kibirli: proud
çözümleri: solutions
geldiğinde: when
ektiler: they supplement
isteği: request
etmesin: you do not
arasında: between
demezler: what they say
iznimiz: our permission
hizmetçi: maid
varlığı: wealth
susadın: are you thirsty
adaletinize: your justice
olmayı: to be
yerleştirmelisin: you must place
okudur: read on
sıhhatine: the soundness
kargalar: crows
alacağım: i will
İşlerin: the works
iyiliklerin: favor of
okudum: i read
alacağız: we will
sevindim: i'm glad
dönersen: if you go
dertlerle: trouble with
defol: get out
gerekiyor: need
yurdu: dormitory
yeniden: again
ölene: who died
peygamber: prophet
şövalyem: knight
yurda: home
ezdiklerinde: they crush
olduklarına: be they
koyulacağım: i will put
isteyip: whether
keçilerinizden: your goat
değerli: valuable
saçlarınla: your hair
İzninizle: with your permission
şahsen: personally
benimkileri: mine
koyulacağız: we will put
dünyasal: worldly
isteyin: ask
getirmekti: i bring
Şişt: schist
yavuklun: the yavukl
iple: rope
utanmalısın: you should be ashamed
hesaba: accounts
geleceğin: the future
tüketme: depletion
nedeniyle: because of
sorunları: issues
onurum: honor
kollarımızda: our arm
lazım: necessary
suçlamalar: accusations
kuşların: birds
canla: and soul
istediğimizi: we want
olmadı: it was not
olmasıydı: it was not
etli: meaty
eftalya: eftalya
asilzadedir: is a nobleman
alma: taking
güvenir: trust
zekisin: you're smart
kurmaya: establish
revan: revan
damla: drop
unutmadan: forgetting
Şövalyeleri'ni: knights of the
amacınızla: your goal
harzemşahlar’ın: the harzemşahlarm
yıldızlara: the stars
ahlat'la: ahlat'l to
etrafını: around the
rezilin: the infamous
kaleden: from the castle
elçisi: envoy
gani: gene
evimiz: our home
öldürdü: killed
abi: brother
oğluyum: my son
iyiliğinizi: your favor
bileyim: i know
göremedim: i did not see
olmam: i have
evlenmesi: marry
olman: do not be
İnatçılık: stubbornness
yarayı: wound
günler: days
gösterecek: to show
sahabettin’e: şahabettin to
boynunu: neck
obasına: tribe to
istemeye: want to
konuşacaklarımız: we can discuss
yangın: fire
minber: pulpit
istemeyi: ask for
istediği: wanted
ufuklar: horizons
yakınlarda: recently
kavuşasın: you have put
azam'ın: the maximum
tepeledik: we have hills
kaçarak: fleeing
dinleme: listening
şaşırıp: i'm stuck
gönderdin: you sent
gönderdim: i sent
umduğunu: hope that
zorluklar: difficulties
yakındır: close
söylüyorsun: you say
kastı: deliberate
hayme'yi: haymi
satmadığını: not sell
işlesin: you handle
burnumuzun: our nose
yiğit’i: valiant
İsmini: your name
dönerse: if returned
yiğit’e: a valiant
hanım: lady
taşıyamayacağı: can not move
onundur: is his
kocamı: husband
bebeği: his baby
hayrola: hayrola
bebeğe: baby
pusatlar: pusat's
gençlerin: youth
oyun: game
düşmanımızın: our enemy
edilecek: will be
desin: you also
güvercinleri: pigeons
bitirmeye: to finish
gidiyormuş: he goes
idiği: i that
dönsün: you return
der: says
dövüşme: fight
deh: gee up
dek: until
dünyası: the world
anlatamadım: i could not tell
haberdi: the news
cambazlar: acrobats
dağıtan: spreading
obasını: obama the
ecel: death
nasır'la: nasser
hastalığından: from disease
atalarınızı: your ancestors
ölmekten: of dying
kalpli: hearted
afşin: the afşin
eceline: appointed to
gelenleri: from the
sakladın: you store
İkiniz: both of you
dikkat: attention
öğrenmeliyiz: we must learn
hükümdarlığında: in the reign
yoksa: or
gördüğüm: i have seen
hırlayan: snarling
etrafına: around
arkasını: the rear
çağırmadım: i did not call
kaybedesin: you lose
özgürlük: freedom
bulurdu: he was found
acınızla: your pain
çekmek: attract
düşürmeyesin: you drop
sevdiklerimi: loved ones
düşünecek: to think
aradınız: you called
ailemin: my family
alpi: alpi
ricalarını: their request
yetmiş: seventy
karşılaştığınızda: when you encounter
konduramazsın: you konduramaz
yaşarken: while living
düşmeden: without falling
dayanamaz: can not stand
onurdur: is honored
ovada: in the plains
ağzıma: my mouth
sabırla: with patience
koş: rushed
öğrendiğinde: when he learned
huyunu: the habit
hissediyorum: i am feeling
mayamız: our yeast
alırım: i get
kuduz: rabies
ödüyorum: i'm paying
kampımızı: our camp
sarayın: the palace
sesdönmek: sound return
bağla: connect
alırız: we take
geçerlidir: valid
akşama: hitch
kalktı: stood
kutuya: the box
meraklılarından: the curious
cadı: witch
oku: read
otursa: if the grass
altındayken: while under
yolculukta: the ride
ağızlarına: their mouths
yanıp: blink
durumdur: the situation is
onları: them
soyu: strain
yapsaydım: should i do
mıhladız: mıhladız
öfkesi: anger
köyleri: villages
iyisini: the best
bilgilendirecek: will inform
cesaretin: courage
bitmeden: the end
girince: entered
çemberi: circle
selçuklu'nun: the seljuks
hükmü: provision
tuzağa: trapped
köşkte: the pavilion
bozkırın: the steppe
neresi: where
kardeşimizi: our brother
şöyle: as
öğrenmen: learning
yapsak: we do
öğrenmek: learn
anlamadım: i do not understand
anlamadın: you did not understand
endülüs: endülüs
örümcek: spider
istifa: resignation
anlamaya: understanding
hatununa: the chick
herkes: everyone
kurtulmalıyız: we need to get rid of
katilin: the killer
şeyde: the thing
çıkmaya: evolution
korkacağız: we fear
durumunu: status
taht: throne
açıldı: opened
durumuna: availability
arkadaşım: my friend
komutandı: he was commander
aydan: month
arkadaşın: your friend
yeğdir: it is better
darbesi: pulse
potansiyellerimizin: our potential
hayrından: from charity
Şah'ımız: our şah'ı
tanıyor: knows
onlara: to them
başkalarını: others
bozok'du: i bozok'
ağızdanallah: allah
peşime: after me
düşünemedik: we could consider
kol: arm
ikiniz: both of you
koy: put
gavur: infidel
bekleyenler: waiting for
gidersin: you go
kor: blind
sıkkın: depressed
dilinin: the language
ayrılmayacak: to leave
sabırlı: patient
para: money
başüstüne: aye sir
sarayımın: my palace
görülebilir: visible
etmeyin: do not
yabanilik: savagery
yılkı: year's
Önce: prior to
etmeyiz: we do not
aşk: love
akar: mite
aksine: unlike
bağlı: connected
kırmızı: red
cennet: paradise
omzuma: omzuma
tahtına: throne
diyorsan: says you
ertugrul: ertugrul
yarından: tomorrow
kızınız: your daughter
İdam: execution
kalacak: will stay
yaran: wound
söylendiğini”: told that &quot;
acıdır: hurts
sürüyü: herd
mümbit: fertile
yarar: benefit
olarak: as
nefes: breath
veriyorlardı: they were giving
bakarız: we'll see
sebebi: reason
koç: coach
turgut’a: turgut
parçaladı: tore
mühimmatlarını: their ammunition
öldüğünü: he died
çatma: declamation
anlarsın: you know
başlasın: commence
duygusal: emotional
çıkamayabilir: you can not go
kayalıklarına: the rocky
yardımcıları: aids
ziyafet: feast
pineklemek: drowse
konuğu: guest
zannettiğin: you thought
kontluğu'nun: the duchy
çekme: pull
karargah: headquarters
olmadık: we have
davullarla: with drums
çekiyor: attracts
gitmeme: to go
şeytanla: the devil
ettiniz: you have
kalbinizde: your heart
yaşlıyız: are old
bedevinin: the bedouin
ihanet: betrayal
oturacağım: i'll sit
thomas: thomas
karabasan: nightmare
neydi: what was it
gitme: go
yatırırız: we invested
duysa: if d
dalındaki: branches in
hillside: hillside
oturacağız: we will sit
vaktinde: on time
olurdu: it would be
pekmezi: molasses
diğerlerini: others
yanmıyor: not well
damgaladım: i stamps
kalbini: your heart
kendisi: itself
yerleşmesini: the settlement
Üzülme: do not be sad
öğrendiğinden: she learned
kabile: clan
kavuşamamak: failure to reach
çoğu: most
duyunca: heard
şimdi: now
obanı: obama the
süslenmiş: decorated
gelebildik: here we come
ilgilenmişti: he was interested
depresyona: depression
binenin: thousand of
içinde: in
haberler: news
kılıcı: sword
mevzuları: matters in
almıştır: took
çıkarmadan: removing
kalkamıyorum: i can not get up
zorundasınız: you have to
uzanıyordu: he stretches
endişelenmek: worry
gösterdiğin: you showed
İçinde: in
sahip: owner
çatışmaları: conflicts
gittiğinde: when you go
evlenmek: get married
gönderecektik: going to send
türüyle: the type
uçar: ends
gecemizin: our night
bulaşmadan: from infection
kuzum: my chuck
acılar: pain
alp'in: the mountaineering
gerekirse: if necessary
bildiriver: bildiriv is
acıyı: pain
çıkaracağım: i will take
fiyonkunu: bowtie
fısıldatacağım: i'll fısıldat
söylerler: they say
yalanları: lies
iki: two
malzemelerini: the material
kazanları: boilers
gülüm: honey
bastı: raided
sultan: sultan
gençler: youth
ışığına: light
krampları: cramps
öldürmüş: he killed
yaptıklarına: do they
öldürmeye: kill
yıllarca: for years
ata'm: my ancestors
çalınanlardan: those stolen
karşı: against
andan: moment
savaşması: the war
sevgiye: love
dağlarda: in the mountains
obana: to me
uğraşırsınız: you struggle
kılıca: sword
yolculuğunu: journey
bahçesine: garden
müttefiklerimizin: our allies
çıkmadı: it came out
kurda: wolf
kesilmiş: cut
kırarız: we break
uzattınız: you extend
âlemi: âlemi
fesuphanallah: glory to allah
civar: vicinity
kalmak: stay
ana'mıza: our main
densizler: dens and
doğrudur: is true
tarikat: sect
alamaz: can not afford
kalmaz: do not stay
edecek: will
söylediklerinde: they say
camii'ne: the mosque
diğerleri: others
şahin: hawk
kuyu: well
ağlayacağım: i will cry
uğrarız: we suffered
bile: even
ulaşamadınız: not reached
obamızın: our tribe
heyt: heytim
tarafımdaydın: side of me
değirmen: mill
olabileceğinden: it may
konuşamam: i can not speak
engb: engb
sevgisini: love
acıya: pain
buluşacağız: we will meet
menem: menem
yaptıklarını: do they
babanın: father
kabileden: from tribe
turgut'a: turgut
oğlusun: you son
çaresi: remedy
duyarım: i heard
sığınan: took refuge
eşkıyasından: the bandit
beklemeliyiz: we must wait
oklar: arrows
kimseye: anyone
ayrılırmışız: we're separated
hazırım: i am ready
bengü: bengü
şehrimde: my city
kabileni: tribe
kabilene: tribe
hazırız: we are ready
ettiğiniz: that you
koca: husband
isterim: i want
bildiririm: i will tell
olmasan: although the
atlarla: with horses
isteriz: we want
avda: hunting
dersin: of course
unutmayacağım: i will not forget
huya: habit to
dişini: teeth
anında: instantly
verdiğine: given that
kimseler: people
izin: permission
Üflemeliler: accents
yaramız: our work
dışarıdan: from outside
sezginiz: your intuition
mavi: blue
edeceğiniz: you will
boşa: down the drain
öldüğü: died
sahipsiz: derelict
Ölmeyi: die
öneriyorsun: you recommend
gerilim: voltage
durdur: stop
boşu: empty
bin: thousand
bil: know
soysuz: bastard
kelime: word
kraliyet: royal
biz: we
taşlattın: you taşlat
göreceğiz: we'll see
bir: one
gidip: go
düşünen: thinking
getirmiştim: i brought
yiğidin: the valiant
vermedim: i did not
yiğidim: spunky
kumaşlarımızı: our fabrics
ortodokslar: orthodox
yetiştireceğiz: we will grow
barındırmaya: to host
tanımamışsın: you recognize
gideceğimizi: we will go
sapmış: warped
cenkten: from cenker
destur: destur
çaresine: the cure
ağabeyim: my brother
ağabeyin: brother
gerçekten: really
istemez: does not want
işimizle: our business
danışmanlar: consultants
taşımak: transport
edemez: i can not
parmağındaki: the finger
pes: pes
pek: very
hayatımı: my life
merhametinizin: your mercy
özlemelerini: not to miss
demedim: i did not say
demedin: beam
eşkıya: bandit
bırakırsan: if you leave
oturun: sit down
oturup: sit
yüzleşmemişsinizdir: you've confrontation
kalmasın: kalmasın
tüner: roost
cevabını: answer
okur: reader
ölüm: death
bağlamış: tied
Çatlayacak: to crack
ölüp: die
çıbanlar: boils
başlarına: their heads
okun: read
ederseniz: if you
sancağı: sancağı
kolu: lever
erken: early
kervanda: the caravan
erkek: male
içemez: can not drink
baci'ye: baciu to
gördü: he saw
kendini: itself
yaşamda: in life
kendine: yourself
doğduğu: birthplace
savaşçı: warrior
temaşaydı: it was matter of show
yapabileceğimi: i can
farklıydı: it was different
kurdoğlu'nun: the kurdoğlu
boya: paint
khalifa'nın: the khalifa
çözmeni: solve
gerçi: though
iner: descends
boyu: length
kaybetme: losing
bulamayacağı: can not find
ortaya: out
uğramış: suffered
kazandım: i won
verme: supply
tasman: leash
uzaklardayken: was away
gidebilirse: can go
neyi: what
pislikleri: filth
alâeddin'in: the alaeddine
adamıyla: the man
töresi: töresi
geçilmez: impassable
fazlası: more than
köpeklerin: dogs
dervişim: religous people
hâlinle: with carpet
borcudur: the debt
edilmemiş: unsubstituted
tezi: thesis
elde: obtained
İzlemek: watch
hilelerin: the trick
atlarımız: our horse
olduğunda: when
içinizde: inside you
çıkarmak: eject
cellat: executioner
etmeden: without
tarafindan: by
kartalları: eagles
gönderecek: will send
olsa: although
ezmek: crush
göndermemiz: sending our
kişileri: people
hizaya: line up
defalarca: repeatedly
maşallahın: i seek protection by allah
ihtimale: case
sonumuz: our end
2000: 2000
derviş: dervish
güzeldi: it was nice
üzüntüyle: with sadness
veremez: can not
yolladılar: they sent
utanmıyor: not embarrassed
değer: value
tahribatın: the destruction
korktuğumu: i'm scared
sevgilim: my darling
hastalık: disease
görmeye: seeing
sensiz: without you
hizmet: service
sensin: you
ikimizin: the two of us
dışarıda: outside
atlar: horses
bizden: u.s
ateşinin: of fire
palazlanıyor: palazlanıy is
korumak: protect
deliler: evidence
salladı: shook
ateşiyle: with fire
soyun: peel
arzulara: to desire
kelimeleri: words
önüne: before
vuslat: meeting
geçireceğimizden: we will spend
tapınak: temple
nesiymiş: what he was
bulacağız: we will find
bey'de: the gentlemen
istediğini: he wanted
ahıra: barn
şehzademi: my prince
gerekebilir: may need
ödeyecek: pay
bilirse: if you know
iyiliğinden: the favor
dönemez: not return
şimdiye: now
serbest: independent
gönderdi: sent
kuluymuşuz: uymuşuz servants
aramıza: aramıza
dezavantajı: disadvantage
bahsediyorsun: talking about
erkeklerin: men
inanmıyorum: i do not believe
gelmez: does not
gelmiştim: i come
sorunumuz: our problem
karanlığa: darkness
ameliyat: operation
şövalyelerin: knights
yenilmez: invincible
atacağını: it would take
zoruna: difficult to
halleder: take care
ölmeyeceğini: would die
kabilesi: tribe
lüzumsuz: unnecessary
peygamberimiz: peygamberimiz
amacın: the aim
amacım: my aim
etrafı: around
anlamalısın: you have to understand
kadem: my foot
uğrayacağım: i'm gonna stop
yiğitsen: the yiğitsan
önü: himherit
dikkatli: careful
zaferini: victory
istemiyordu: he did not want
bağırmayı: shouting
işimize: our business
30: 30
mevzu: subject
ödedi: paid
İbnülarabî: ibnülarabî
yolculuğumuz: our journey
sökmez: no go
kalsam: i stay
seferleri: expeditions
yettim: i feed
yaptıklarından: they did
mahvederim: i will destroy
umutlarımız: our hope
darbeyle: coup
ederim: i would
obandaki: in obama
tedbirsizlik: imprudence
sivrisinek: mosquito
cihan: universe
yapıyorsun: you are doing
esirleri: prisoners
özgür: free
düşündüğünü: you think
içlerinden: of them
avlanırsa: if hunting
yemedi: he was eating
avrupa: europe
pişman: regret
vereceğini: would give
uzatma: extension
doldur: fill
işbirliği: cooperation
aynada: in the mirror
tövbe: repentance
zalimlere: to cruel
huzurunda: before
yapıldığını: it's done
hâzirûn: attendee
sırasında: during
tepeleri: hills
yapacaktır: will make
halt: heck
olacaksınız: you will be
derdine: troubles
yolladım: i sent
soframıza: soframıza
getirmişsiniz: you brought
yeksan: yeksan
solumak: breathe
tırnağıyla: the quotation
çirkinliğine: the ugliness
öldürdün: you killed
Üzgünüm: sorry
budur: this is
devletmiş: that state
birlikteydin: you were with
olmaya: not to
nimettir: it is blessing
insanın: people
ayarlarına: the setting
döktüm: i shed
atıyorsa: if taking
birileriyle: with one
reva: reve
varın: there
kızına: daughter
getirdiğinde: when brought
düşünmedik: we think
varıp: arrive
şifalı: healing
başka: another
değiştirmediyse: if change
vakitler: time for
yaslanmak: get old
de: also
mıydım: did i
kanıtladın: you proved
merkezdeki: in the center
ayarlamalıyız: we must adjust
karanlığı: dark
kadere: fate
hakkında: about
duymuştuk: we heard
yaraşır: worthily
sıkıntıyla: dismally
kadın: woman
tüccarmış: that traders
üzerimizde: upon us
isteyen: want
şaşırıyor: is amazed
çadırda: canvas
komutanı: commander
kumandanlık: high command
vezirimin: my veziriye
sağlayın: provide
ölümün: death
babana: to your father
yolculuğu: ride
belirtir: specifies
yolculuğa: road trip
emsal: peer
bunca: so many
belirtin: specify
yunan: hellenic
erkekler: men
anlaşmayı: agreement
bizimdir: it is ours
suçlamaya: accusation
verdiğin: you gave
verdiğim: i gave
düştüğün: you fell
rabb: lord
aralarındaki: therebetween
dönme: rotation
dal: branch
İhtiyarlık: old age
geldiğimiz: we come
yapıyor: doing
rahat: comfortable
senindir: it's yours
gitmişti: had gone
hazırlattım: i prepared
kalıyorsun: you are staying
zevk: taste
sahabettin'i: the şahabettin
tamamını: all
hafta: week
zamanlarında: in time
aşılacağını: will be overcome
basra'ya: basra
batısı: western
selcan: selcen
satmamız: we sell
saldırırsa: if the attack
çözülecek: be solved
bulmam: i find
emaneti: escrow
unutmuşum: i forgot
soğuklarda: in cold
tarİhlerİmİz: our history
kervandaki: the caravan
aga: aga
melun: accursed
gardaşlarımıza: our gardaş
edilmem: i'm not
misafir: guest
masaya: table
yükledim: i installed
ediyorum: i would
canımı: canımı
uzak: far
edildi: it was
obanızda: your obama
şerbet: sherbet
ediyoruz: we do
uzat: extend
düşünce: idea
izleyenler: followers
yara: wound
aksın: albino
moğol: mongolian
başyaveri: the başyaver
kardeşimiz: our brother
seçecek: elect
kapana: closed
kötülüğün: the evil
karnınızı: your stomach
şehzade: prince
türklerle: with turkey
yıkılsa: were destroyed in
ederken: while
kaçının: avoid
haklıyken: justified by
kılan: makes
barış: peace
destursuz: destursuz
nimet: blessing
tazelenmiş: refreshed
tekeye: goats to
parçası: part of it
getirmezsen: do not bring
yalnız: alone
tüketmeye: consume
mesaj: message
dağ: mountain
kullanması: to use
ağlayabilirsin: you can cry
biçileyim: i cut
dilsiz: dumb
yiğidime: yiğidi to
babanı: father
güzelmiş: nice
tokat: slap
etmekten: from to
balta: ax
iyileşti: recovered
insanlarmış: people who have
yeni: new
sadık: loyal
önem: importance
alplerim: i alps
alplerin: the alps
padişahı: sultan
gelmeyeceğini: will come
selamünaleyküm: selamun aleykum
ayakta: standing
kesip: cut out
düşünür: thinker
duramayacak: can not stand
anlamıyorsun: you do not understand
saklan: hide
sürdürmek: maintain
gösteriyor: is showing
endişelisiniz: you worried
azından: least
hava: air
selametiyse: if salvation
idam: execution
deliliği: madness
köşesinde: on the corner
mil: shaft
aladdin: aladdin
beysin: you guys
sunduk: we offer
sıran: the order
etrafında: around
götürdüğüne: take that
ordularıyla: with army
beysiz: beys
tanımlamak: define
halkımızın: our people
sadece: only
salli: salli
dinleseydin: would listen
açtığın: you hungry
lakırdılarını: the or talks
geride: back
söylüyordun: you say
İkisi: the two
gurur: pride
dirisin: you're alive
işle: process
taşıyorsun: you carry
allah'ın: god
allah'ım: allah
konuşacaksınız: will speak
mi;: ml;
gibisin: you seem
üzgünüm: sorry
gelen: incoming
çalışıyor: working
okuldur: and school
girmesi: entering
ordusuna: army
göğsünde: on his chest
yapmadım: i did not
ordusunu: army
kurtulduk: riddance
kenger: acanthus
kurtuldun: did you get
türk’ün: turkey's
gideceksin: you go
yurtsuz: homeless
öldürüldüğünü: he was killed
düşürecekmiş: going to reduce
amanos: amanos
satan: selling
elim: my hand
elin: your hand
devletimi: my state
karadere: karadere
kırılmış: broken
gölgeleyecek: to overshadow
duymuşsundur: you've heard
ölü: dead
günah: sin
yanındaki: side
Üzerime: upon me
sözleriz: we contracts
cesur: brave
toyda: the meeting
Şeyhimize: our sheikh
söyleyeceğimi: tell me
tanımıyor: does not recognize
hediyelerimiz: our gift
sözlerin: the words
haçlılar: crusaders
kemirmekte: being gnawed
odası: room
döneceğini: will return
yerleştirdiler: they put
gerçekleri: facts
etmişsin: you've been
akılını: the mind
Üç: three
oyulaydı: it was carved
çıkacaklar: will be going
anılar: memories
arabi'nin: the arabian
arkanda: behind you
fakat: but
iyileşiyor: healing
önceden: previously
ülkelerden: the country
gitmeyecek: i will not go
ihtiyacınız: you need
şüphe: doubt
dertlenmeyi: to dertlenmek
kararacak: will decide
geberteceğim: i will kill
annemin: my mom's
fırtınadayız: we fırtınad
halletsin: you care
kocamak: grow old
bugüne: today
annemiz: our mother
gündoğdu'ma: gündoğdu'nun to
düze: straight
kimse: nobody
korkutan: the scare
kurtulmanıza: get rid of your
alpler: alps
burada: here
rahattın: you comfortable
denir: called
konstantiniyye'yi: constantinople in
çapul: booty
gerekmeyecekti: would not need
odaklanabilir: focusable
söylüyoruz: we say
duruyor: stands
ahırlar: mews
kullandılar: they used
damgalanmış: stigmatized
göçü: migration
meseleyi: matter of
söylüyorum: i say
gaza: gas
gazi: ghazi
süpürüldü: swept
taşımazlar: carry
ahval: ahval
kabilemizde: our tribe
ahlat'taki: the pear
al: get
bulaştırdın: dragged
biteni: going
abdühü: abduh of
halimelerin: malaria state
geldiyse: if you came
saçlarını: your hair
dertte: in trouble
kapım: my door
cehennemde: hell
ettiğimi: i've
bulduklarına: they found
kulağım: my ears
bakılırsa: judging
atadan: from ancestors
becerebilecekler: be able to fuck
eşyaları: goods
söylemezdin: you say
ay: moon
kimseden: from anyone
yitirmemişimdir: lost mamişimdir
koruması: protection
Çağrılmayan: not called
gerek: need
gösterdiği: showed
kendimize: ourselves
badireler: trials and hardships they
karşına: although
emriyle: by order of
saraydan: from the palace
kararından: decision from
emretti: ordered
kardeşiniz: your brother
huzuru: peace
gelinle: bride
kardeşinin: brother
ayılarla: bears
dönüp: return
dövüş: fight
gelinimiz: our bride
misin: will you
ayrıldı: left
hoşlanmıyorsun: you do not like
istirahat: rest
dinlenmek: have a rest
kalacaklar: they will be staying
dönün: return
geldiniz: welcome
khwarazmshah'ın: the khwarazmshah
bildiresin: press report
İstediğim: i want
İstediğin: you want
ömrüm: ömrüm
tekrar: again
biçti: hewed
anadolu: anatolia
evleneceğiniz: you married
vakit: time
bence: in my opinion
çok: very
kapalı: closed
olduğum: i'm
arkadan: behind
misafiri: guests
görme: seeing
hazırlamalarını: prepare their
hayatı: vital
içindesin: you're in
haçlıların: the crusaders
getireyim: i bring
teşekkür: thank
kokunuzdan: your smell
toplayabilir: you can collect
merkezde: in the center
ortalığı: mess
testi: test
içindir: it is for
isyancıları: rebels
sıradağlar: mountain
vermezsem: i do not give
olacağı: will be
ölümü: death
shahzade'yi: the shahzade
hekim: physician
sürülerinizin: your lot
dertlerden: from trouble
tazelenmesi: refreshing
gelmekte: coming
uygulamak: apply
hain: traitor
güvenmek: trust
ayıracağım: i'll reserve
kayı'yı: beech
bulamadığın: they could not find
pusta: the haze
maruz: exposed
bıraktın: you left
tepesi: hill
ziynet: trappings
prensesim: my princess
veba: plague
atımı: throw
zekâna: intelligence to
ocağımız: our quarry
tehlikeli: dangerous
birine: to someone
cenaze: funeral
dediklerimi: also what
birini: one
istiyorsun: would you
yalvaracaklar: will appeal
leşini: the carcasses
çadırın: the tent
cihana: cihan
cüretle: dare
konuşman: speech
konuşmam: my speech
taşları: stone
konuşmak: talk
haneye: households
dönemeyeceği: not return
sürtüğünün: the bitch
arzumuz: our desire
zengid'in: the zengid
gönül: heart
toprağa: ground
çıkanlar: featured
sonrası: post
çağrısında: call
agabeys: elder brother
yapıp: make
istiyoruz: we want
istiyorum: i want
yapın: make
elhamdülillah: hallelujah
yürüyor: walking
hesabını: accounts
dönemezsin: you can not
bilirsin: you know
bekledim: i waited
halep'teki: in halep
etkileyeceksin: you're gonna impress
olaylarını: events
İsa'nın: fast
olur: would
kitap: book
atarlar: they appointed
buz: ice
kızı: daughter
yakınlardan: the recently
quort'larınızdan: your quort
hayatımdan: my life
dinle: listen
bul: find
hırsıyla: with ambition
meclisini: the council
kalakalmazdım: i would not have stood
bozulmuşsa: it is distorted
sorayım: let me ask
dışındayız: we're out
getirmişsin: you brought
kubbe: dome
bilincini: awareness
yapılan: done
gerekmeyecek: should not be
doğduktan: is born
yiğitlerimize: our brave
babasından: his father
muhafaza: preservation
karşısına: against
döksün: you pour
alsan: alsan
pis: filthy
80: 80
mahremidir: it is confidential
joseph'in: joseph
toprağı: earth
reddet: rejected
endişelenmeli: be worried
hatırlayan: reminiscent
yiyebilirsen: if you can eat
değecek: worth
kurmalıyız: we should establish
oluyor: is happening
öldürür: kill
öldürüp: killing
erkekya: male or
saldırsalardı: they saldırsı
karıştırır: confuses
kayı'ya: slide into
çekti: drew
kaçıyor: fleeing
kutlu: happy
çocuk: child
gece: night
bebeğimiz: our baby
etmedi: i did not
zorlukta: difficulty
başardınız: you managed
güvendiğim: i trust
muhiddin: muhiddin
güvendiğin: you trust
zekânı: the intelligence
korkudan: the scare
saklayacak: will store
avrupa’ya: avrupaya
olabilseydim: i could
işimi: my job
dert: trouble
ders: lesson
indiğimizde: we landed
tıkar: clog
biline: to know
deri: skin
hata: error
dere: stream
tebrik: greeting
yapmazdın: would not do
mazeretler: excuses
faresi: mouse
buyur: commanded
değildi: it was not
“kuşlar: &quot;birds
isimlerinizin: your name
mı: is
şeylerden: anything from
inciterek: hurting
melike: melika
kolaylaştıracak: to facilitate
babamızdır: our fathers
yoluma: my way
gelmeyin: to come
adlandırdıklarını: they call
halebi: of aleppo
kolyesidir: a necklace
gözden: review
verip: whether
verir: gives
yakalamak: catch
atıp: throw
kılıncımla: with kilinc
basmış: ridden
Şahzad: şahzad
eliniz: your hand
yüceltir: glorifies
güvendiği: that trust
yapacak: will make
bulutlar: clouds
verin: give
mededim: i medea
doğdu: he was born
erlerimizin: our sooner
almış: received
kullanmadık: we did not use
keşgir: kesgin is
emredersin: you ordered
pisliğini: mess
aslında: actually
toygar'a: a meeting
tükenene: exhausted
çalmışlar: they stole
annemizin: our mother
vermezse: does not
çadırdan: the tent
atmak: throw away
İstediğini: he wanted
uykuda: asleep
kum: annual
yarısı: half
atmaz: do not throw
sahabettin: şahabettin
düşecektir: will fall
bulabileceğimiz: we can find
duymuşluğum: i am familiar
istemiştim: i want
satacaklardı: they buy
gidiyorsunuz: are you going
çalışıyoruz: we are working
tırnaklarımla: with nails
öldüremeyeceğini: not kill
kesti: cut
çalışıyorum: i'm trying
ettiğinizi: you've
seçmiş: have chosen
haklısınızdır: you're right
yükle: load
kaçırmaya: do not miss
alplerimizin: our alps
ortam: environment
yakıştı: looks good
getirdiği: brought
arıyorum: i'm looking for
oğlunun: the son
kurumuş: dried
kahire'den: from cairo
haklıdır: it is right
yargının: the judiciary
götürmek: take
kaldınız: you're
mahkumu: prisoners
içten: internally
köşede: in the corner
çıkması: to go
sabırsızlanıyorsun: you can not wait
latince: latin
sahibine: author
sebebiniz: your reason
vermiş: he has given
kabilemize: our tribe
endişelenmesi: to worry
aykız'la: aykız'l to
bükeceğiz: we twist
güvenebilirim: i can trust
fakih'e: jurists to
alpler'in: the alps
akın: influx
ihtiyacımız: we need
büyütüyorum: i'm raising
susmaz: shut up
çıkardı: pulled out
kötüsü: worse
sakalını: beard
bağışlayın: pardon me
sevin: rejoice
toygar'la: toygar'la
fakir: poor
mi: did you
mu: is
kutsar: blesses
kuş: bird
yaşında: aged
ederiz: we will
şunun: the following
geçmesine: go to
tekin: the only
“mawaqi: &quot;the mawaq
direği: pole
ağızdan: oral
tanrı: god
buna: this
Çekil: get out
ayrılık: separation
karşılaşacağınızı: to meet
sürmez: it will not take
kadar: until
gönlü: hearts
yapmamalısın: you should not
bunu: this
müslümanları: muslims
vermezsen: if do not
bıçakların: the knife
olmuyormuş: be muyormuş
yıllar: years
evlendireceğim: i'm going to marry
ötede: beyond
olmadığımı: i have
memnun: satisfied
amin: amine
bey'imiz: our bey'i
engelleyebilir: may prevent
gündüzün: daytime
dansını: dance
aslanlarla: lions
Çadırındadır: the tent is
mü: is
gidi: go
yorumlayacağımı: i reviews
cevval: cevval
farkında: aware
pişmek: be cooked
namaz: prayer
oynayıp: play
haklısın: you are right
evcil: domestic
bulamayacaksın: you will not find
ima: glance
beylerim: my guys
neler: what
gözlerine: eyes
düzenlediği: organized by
gözlerini: your eyes
sıkıldım: i am bored
ayırmadım: i release
hakim: judge
yaşatmayın: the survival
anladığım: i understand
kısılırsa: if trapped
gazabı: wrath
kalması: stay
küçük: small
korkmam: i fear
bacım: my sister
öğrenmeyeceğiz: we will learn
aynı: same
hastalandı: he fell ill
yetiştiremiyor: not can raise
yapıyordu: i was doing
söyleyerek: saying
görecekler: they will see
birleşti: united
alaaddin'den: from alaaddin
alev: flame
ejderha: dragon
sultan'ı: sultana
koyulmak: sit down
diye: that
yatağının: of bed
yardım: help
dünyanın: the world
inatçıydınız: did stubborn
kurdoglu’yu: the kurdoğlu
yanı: so
unvanını: title
sesyolun: sound of the road
bakayım: bakayım
güvenemeyiz: we can not trust
çekerken: shooting
kurdoglu’ya: kurdoğlu to
ağabeyisin: you're my brother
etmelerine: not to
kaçırabiliriz: we might miss
kurtardıktan: you recover
kutsamaya: blessing to
bacımı: my sisters
taşı: move
ulaşacağız: we will reach
tezekleri: the dung
taşımaya: transportation
istemiş: want to have
güzellik: beauty
birkaç: a few
seninkinden: than yours
gerçekte: in reality
örnek: sample
şehrimize: our city
uçuracağım: i'm gonna blow
dört: four
evlendireceğini: to marry
sakin: calm
yaptığı: his
soyumuzun: our lineage
meselesini: the issue
kazık: stake
gidecek: will go
toy: meeting
sultan'a: sultana
haçlılarla: with the crusaders
aptallığı: foolishness
önümüze: in front of us
topladı: gathered
alırdım: i get
kampın: the camp
göze: to eye
gerçek: real
seviyorsan: you love
haberciler: messengers
malları: goods
nezaketin: courtesy
örer: is e.g.
muydu: was
ağzının: mouth
kalbimin: my heart
Üretİmİn: production
aldığımız: we received
anlayacağın: you will understand
anlamam: i understand
telaşlandırdığına: that alarmed
akına: flock to
masadan: the table
anlamak: understand
alıp: take
alır: gets
evlilik: marriage
sevdiklerinizle: loved ones
istediğimiz: we want
gizlice: secretly
efendi'yle: efendi
alın: learn
ağacın: the tree
Âdettendir: it's traditional
gidemezsin: you can not go
ağa: network
geçen: last
görseydi: he had seen
gözü: eye
eyvallah: thank you
vazgeçmek: give up
öldürdüğünüz: you killed
dayı: uncle
mümkünse: if possible
kuyudan: from wells
birlikteyken: were together
sevinebildiğince: sevinebildiğin by
şövalyeler: chivalry
derman: cure
bizimkisi: ours
mother: mother
gözlemekle: while opting
karındaş: karındaş
kâfirler: unbelievers
karatoygar'la: karatoygar'l to
yollayacaklar: roads will
gözyaşlarımı: my tears
ölüsü: dead
metal: metal
konya'dan: from konya
kafanın: head
yana: sideways
sınavdan: the exam
aykiz'im: i aykiz
Şah'tan: the shah
yani: so
köpekler: dogs
verdikleri: they give
olamaz: can not
pusatlarımız: our pusat
kaçırdı: missed
bırakmazdı: would not leave
doldu: has expired
haçlılardan: the crusaders
çıkmanız: you go
faydalanmaktır: to benefit
biçeriz: we reap
işleyeceğine: would work
vizierimize: our vizieri
canımdan: canımdan
pusuda: on the lurk
yanına: next
sığınmaya: take refuge in
değilim: i am not
büyükbaban: grandfather
kurbanlık: the sacrificial
büyükbabam: my grandfather
vermektense: rather than give
konuşmadın: you talk
goons: goons
şansımız: our chances
buluşacağım: i will meet
sorunlarını: issues
çekmeliyiz: we should also draw
öldürürsem: if i kill
ayarladım: i have set
gününde: on the day
elinizi: your hand
ayrıldılar: they left
kalkarsanız: if you get up
yaparken: while
belledin: you belle
yakında: soon
taslamaya: a grinding
uyuyakalmış: fell asleep
Şöminenin: fireplace
gönderebilirim: i can send
açılır: opens
düşünüp: thinking
mücadele: struggle
düşeceksiniz: will fall
olacaktı: it would be
hükmedemediğimiz: we can not afford
duyduysan: you've heard
buldu: found
keferenin: the kafara
bağlanmış: tied
aşiret: tribe
kızımız: our daughter
belirtmez: it does not specify
dalga: wave
çağrının: call
sahiptir: it has
hakkına: right to
isteğim: my request
gidebiliriz: i could go
kimmiş: who
araya: together
haçlıyla: with crosses
hiçbirini: none of the
devletli: state
müslümanlardı: they were muslims
gidebilirim: i can go
sedef: pearl
kestiler: they cut
heyecandan: the excitement
mutlu: happy
soluktu: he has faded
koyulmadan: you hit
iyiliklerinin: of kindness
töreye: ceremony to
aslanım: lion
başarısına: success
koşu: running
sorunlarına: the problem
öldü: died
yaşıyor: lives
bulursun: you'll find
yaydan: from spring
konuyu: subject
zayıflığımı: my weakness
habersizsin: are unaware
olun: be
vatan: homeland
düşman: foe
oluk: groove
etmeleri: to the
konuya: subject to
uyumadan: without sleep
çıksak: exit
olup: the
aklının: of mind
münasiptir: it is apposite
buluyorsa: if you find it
bileğine: the wrist
nelerle: what with
gibidir: like this
konuşarak: by talking
göğüs: breast
geliriz: we come
kaçınmadım: i refrain
ruhunu: spirit
gelirim: revenue
misafirlik: residencies
leila’m: i leila
düşerse: if it falls
şanslı: lucky
vermeyecektir: will not
gelmişken: incidentally
anlaşılan: apperantly
annelik: motherhood
saraydaki: the palace
güçlüklerle: difficulties with
işlere: jobs
cırcır: diarrhea
işleri: jobs
baktın: did you look
baktık: we look
kendim: myself
aldırışsızlığı: indifference of
sıradan: ordinary
mısın: will you
fazlasıyla: more than enough
avdır: are hunting
maşallahı: I seek protection by Allah
madem: since
kartal: eagle
ağabeyimi: my brother
sunmak: offer
korkusu: fear
hazırlığı: preparation
ağabeyime: my brother
çıkarma: extraction
tembel: lazy
solucan: worm
medine'ye: medineye
peşlerini: to advance
ahırda: barn
dayanamıyor: can not stand
Şövalyelerinden: the knights
efendin: the lord
söylüyorlar: they say
bilinmesi: find out more
biriyim: i am
bitince: finished
kenarında: by
senden: from you
öldüreceğini: would kill
fikrini: idea
yavuklusu: the yavuklu
kardeşlik: brotherhood
gökleri: heavens
hakkını: the right to
armağan: gift
beklersin: you wait
görüştüler: they discussed
Öfke: anger
güveni: trust
konuşmayacak: to talk
gündoğdu: gündoğdu
durmamalarını: stop them
belirleyeceğiz: we will determine
bakıyorum: i'm looking
denen: tested
düşünmedim: i think
anlamışsındır: you understand
konuşmuyorsun: you do not talk
geçer: passing
kılıçla: the sword
baltanın: the ax
bayrağını: flag
baskınına: raid
bakacaktık: would look
boyuna: longitudinally
eli: his hand
doğduğum: i was born
attı: threw
konuşacağız: we'll talk
aradığın: you seek
ekselânsları: your highness
türkmenlere: the turkmen
ele: addressed
yaptığında: do when
gelecek: the future
umutsuzluk: despair
suzan: suzan
konuşacağım: i will talk
toygar'ın: the meeting
saldırmıyorsunuz: do not attack
yurtmuş: been abroad
göstermeyen: show that
aldatılmak: be cheated
öldürmeden: without killing
hazırlıyorlar: they prepare themselves
ustad: master
beklemekten: the wait
şaşırdım: i was surprised
ahır: barn
adamları: men
Şimdiye: now
güven: confidence
tadını: enjoy
endişelisin: you're worried
güvey: groom
öylece: just
vallahi: by Allah
babasını: father
başkaları: others
yıldızların: the stars
etraftakilerin: of surrounding
canlı: alive
sorarsam: i ask
beylik: hackneyed
anlatacakmış: going to tell
saplanma: stab
dişiyle: with teeth
ilet: forward
gam: gamut
kargısını: the pike
derdimiz: derdimiz
sorgulama: questioning
geçirelim: let my
konstantin'i: constantine the
miydiniz: did you
seferinde: at a time
ölmediyse: if death
gidene: to the
perişan: miserable
dinlemedi: it was listening
peşinde: behind
çizgisinde: in line
obadan: from tribe
ziyade: rather
aha: aha
çeneni: up
kadınlar: women
söyleyemez: can not tell
ahh: uhh
bizlerle: with us
mahkumlardan: of the prisoners
bıraktığım: i left
merhem: ointment
yakın: near
git: go
gir: enter
karavanı: caravan
giy: wear
birleşecek: will unite
aykız'ım: i aykız
inançla: faithfully
diletmek: to diletta
bilmezlere: to know
istemesi: ask for
yakıp: burned
unutmuş: have forgotten
sığdı: it was shallow
adımı: the step
sığınmak: refuge
dilerseniz: if you wish
yuvamız: our slot
geleceğini: the future
koymam: i put
kıskacında: in the grip
la: la
hamza'yı: hamza
karşılıksız: unrequited
aktolgalı: the aktolgal
Çıktığım: i quit
bedelini: cost of
sıkılmazdın: you would not get bored
parlayacak: will shine
yaralımız: our wounded
bıktım: i'm tired
pazara: market
Öyleyse: then
bildi: i know
vermen: do not
olmasaydım: i had not
na: na
elimde: in my hand
tedavisi: treatment
ne: what
şaşırmadım: i'm not surprised
istenmediği: undesirable
kaldı: stayed
çıkacağını: will come
başmışlar: they head
obamıza: tribe us
kabilelerle: with tribes
hakkı: right
şereftir: it is honor
hedef: target
dönse: rotates at
gitmeli: should go
kalkıp: up
Şövalyeleri: knights
saraylı: saraylı
krallığındaki: in the kingdom
Şövalyeleriyle: with the knights
mohammadanslar: mohammadans on
döndük: we returned
görmekten: to see
geçirmişler: they spent
olsaydım: if i were
sağlamsın: you sound
olsaydın: if you were
allah'ını: the god
göstermeden: without showing
ertuğrul'dur: it is ertuðrul
umuyorsun: do you
renkler: colors
torunumuz: our grandson
çığlıkları: cries
selamlarımı: my greetings
götürüyorlardı: they were taking
hayallerini: dreams
uzaklaştıran: zoom out
merkezindeki: center in the
düşünme: thinking
dönemezsem: i do not rotate
demek: say
demem: i also
demen: demen
sorarsan: if you ask
yolculuktan: the journey
zindanlara: the dungeon
verildi: he was given
çalışmışlar: they tried
şimdiden: already
emriniz: your order
edeceğimizi: that we
Öldüğünü: he was dead
karşılarsın: you meet
birer: a
verirdi: he gives
birleştirir: combines
durmaz: does not stop
sözüme: promise to
çalın: theft
anlıyor: understands
ihtiyaç: need
durmam: i will not stand
çağırmamdan: my calling
kaçmasına: escape
döktüğüm: i pour
çarpıksa: a skewed
temizledim: i cleaned
sordu: asked
gemiyle: by ship
atalarımızın: our ancestors
çılgınlarımız: our crazy
yayacak: will spread
savaşçılarını: the warrior
baka: look
kişiyi: people
bilirdin: you know
bırakacaksınız: you will leave
kelimeler: words
bırakacaksın: you leave
kaybolduğu: disappeared
İçimi: smoking
artıkları: residues
pürüzsüz: smooth
inerken: descends
bağışladı: donated
girdiğini: enter the
fişi: plug
kısmetine: fortune
gecikiyorlardı: they delayed
tabiki: of course
sayılır: counted
vaktimiz: our time
çobanları: shepherds
zorlukların: difficulties
dışta: in foreign
olursanız: if you
bey'sin: you guys
hanedanından: the dynasty
canınızın: your car
kıyarsa: if meat
önce: prior to
muhammeden: muhammad the
koptuğu: broke
yapıyordur: he is doing
Üzülmek: fret
kayılar: beeches
olmayayım: i'm not
dertler: trouble
kahramanlara: heroes
yerle: razed
yüceltmek: exalt
keyfin: enjoy
bulunduğu: where
Çocuk: child
önlem: prevention
yaşaması: to live
antakya'ya: antioch
anda: currently
yeterli: enough
ulaştır: deliver
aslını: the original
shahzade'nin: the shahzade
yaşayacağını: to live
geçersiz: invalid
yaşlandıkça: ages
yakma: incineration
padişah: sultan
darbe: coup
büyümüştür: it grew
canım: my dear
canın: the soul
anlatacaksın: you're gonna tell
çalış: work
yaşamadığım: i live
yaşatmaz: yaşatmaz
başladığı: began
uğratma: do not let
demeyin: do not say
yaparım: i do
titremeye: tremble
geldiğimi: i come
gelsene: come on
baskından: the raid
vatanımızı: our homeland
yurdun: the country
arayacağım: i will call
gizlediğini: he hides
suçlanıyor: accused
Şehzadenin: the prince
dileğim: my wish
yüzün: your face
alplerimle: with the alps
dikilmiş: planted
vazgeçmeyeceğiz: we will not give up
yağmaz: not oil
birleştirdim: i combine
kervan: caravan
düşünmemdendir: s just because thinking
meşgale: pastime
içindedir: is in
savaşçılarına: warriors
sizle: with you
konuşanlar: speakers
kıvrılıp: curl up
vücuduna: body
kervanla: caravan supplier
deve: camel
geçmez: does not
sultanı'nı: the sultan
niyetin: the intention
niyetim: my intention
Öldürseniz: if you die
hİkayeler: stories
geçmek: pass
anlaştık: agreed
gidiyor: going
geçmen: do not go
sonrasını: after the
nöbetçi: guard
yaparız: we do
eniştem: my uncle
toplayın: gather
duyuyorsanız: if you
sakın: do not
yalancılar: liars
bağdat'ta: in baghdad
bastırın: press
bacak: leg
coğrafyanın: the geography
elçisini: envoy
nedeni: reason
söylediğimde: when i say
bebeleri: babes
kaçtılar: they fled
semireceği: will fatten
aldıracaktır: will heed
tamamla: complete
alınabilecek: that can be taken
sevmem: i do not like
aklını: your mind
sabah: morning
kaçırıldı: he was kidnapped
tapınakçıları: the templars
basmaların: pressing the
bekleyeceğim: i'll wait
hâl: status
şımarık: sassy
terk: abandonment
vizeri: the vizer
kurtardım: i saved
kirletemez: not pollute
çıban: boil
aklın: the mind
kiraladıkları: they hired
İkimiz: both of us
aklım: my mind
hepsini: all
sevinçliyim: i was happy
kâfir: infidel
yürür: walks
güzelleşti: i flourish
hepsine: to all of them
yüzünden: because
gayrı: non
zorluğun: difficulty
bunalttı: troubled
utanç: shame
bırakmayın: do not leave
şapkan: hat
iyisi: good
misafirlerinden: guests of the
boyundan: neck
farklı: different
ağırlığını: weight
müşkülüm: my predicament
kalabilir: may remain
müşkülün: the chancery
durdurmadı: stopped
suçluyorsun: blame you
kısmı: partial
düğünümüz: our wedding
uğraşmanın: do not bother
etmemeliyim: i should not
selametle: soundly
gelemedi: could not come
beraber: together
nefesiniz: your breath
yakınındayken: are near
geceki: night
sarayından: the palace
edildiğini: is that
ağamla: with network
komutanlık: commands
amma: amman
yuh: hoot
kalsın: keep
delikanlıdır: it is a lad
yumruk: punch
ceza: criminal
evladım: son
evladın: the son
tapınakçılara: the templars
fırsat: opportunity
bakacak: look to
kızdın: you girls
kaçamadık: we did not run away
aklına: his mind
evladır: son is
toplamaktaymış: collect maktaymiş
yanlarından: from the side
eğlendirmek: amuse
ekmeğini: the bread
satılacak: to be sold
kaçmana: escape
kaçmamalı: should escape
kazanlarına: to win
almıştı: had received
çıktığını: come out
gözlerimle: my eyes
atasının: of ancestors
gereği: should
dizinin: directory
dertleriyle: trouble with
bırakamam: can not leave
İstihbarat: intelligence
haberi: news
alay: regiment
yapmaktır: it is to make
güvenen: trusting
çekersin: you are
adamlar: men
tutarız: we hold
ötekilerde: in other
solucanlardan: worms
cenneti: heaven
kullanmak: use
göçelim: i göçel
ikisini: both
and: and
ana: mother
cengâverler: warrior in
faydası: benefits
ant: time
dolduracak: to fill
tatlıdır: it is sweet
gönlündeki: in hearts
abdulkadir: abdulkadir
besleyeceğim: i will feed
ağabey: brother
çadırdaki: tent
çıkmış: out
iyilik: favor
teklifimi: my bid
benim: me
seninki: yours
olamam: i can not be
uyu: sleep
kardeşler: siblings
durmamalı: must stop
teyzeciğim: auntie
hanımefendi: lady
sahabettin'le: sahabettin'l to
mareşlerden: from mareş
yorulmaktan: being tired
gelişim: evolution
gayri: non
geberttik: we kill
kızıltepe'deki: in kiziltepe
üzereydim: i was about
bazıları: some
etmese: had not to
düğünler: weddings
yemeklerinin: of food
sınırlarımızı: our borders
etmesi: do not
bedevilerin: bedouins of
ayrıldığımızda: when we left
üfler: blow
devletimiz: our state
sırtını: his back
neyimiz: what do we
nefeslensek: intrinsic breath
Önümüzde: in front of us
bittiğinin: that bit
yüzle: face
yatmayacağınıza: whether to go to bed
yapamadı: could not
beyninizi: your brain
yeğenime: niece
kaderime: my destiny
mazlumların: the oppressed
yolculuklar: journeys
iyileşiyordu: it was healing
esirlerin: prisoners
favor: favor
rezil: infamous
umuduyla: hoping
beceriksizliğin: of incompetence
adamlarımın: my man
yaşadığım: i live in
yaşadığın: you live
kese: pouch
demeden: bundles
deriyi: leather
vermiyor: does not give
emanetimize: safety us
gelinim: my point
lanetlerle: the curse
hayatlar: lives
masal: tale
olanlara: those who
gittim: i went
olursa: should
gittin: you went
getir: bring
eylemedik: we could not eyle
halimeler: state studies
söyleyecekti: would say
korumamız: our protection
vesveseler: illusions
dolduralım: i fill
getirdiğin: you brought
dönebileceği: could return
kalmadı: sold out
bisol: bisol
rahatla: relax
onlar: them
Şah’ım: shah
arıyordun: were you looking for
niyetlisin: you intentioned
zamanında: on time
yüzlü: faced
elinizden: your hand
kaldırsan: if you're
Şehzadesiyim: i şehzadesiy
sorgulamadan: without question
sokaklarında: the streets
başlamış: started
öğrenmiş: learned
otlak: pasture
kalıntıları: ruins
kaybettiğin: you lost
gecenin: night
tercüme: translation
yürüyenin: the walking
ulaşmak: reach
sualin: the sprinklers
gökyüzüne: the sky
girmesine: enter the
yoksun: devoid of
tereddüt: doubt
oyununu: the game
yoğurmak: knead
göndermeni: sending
inemedi: failed in
misafirlerimizin: our guests
ayağım: my feet
karatoygar'ı: the karatoygar
kapanabilmesi: be closed
kışlası: barracks
meraklısınız: you fancier
bilmiyorum: i do not know
aklından: on her mind
gömmüyor: not bury
bilmiyoruz: we do not know
hediyelere: the gift
konuşurken: talking
yiğit'i: valiant
kızımla: daughter with
bitiyor: ends
gelmişsin: you come
hepinizi: all of you
oğlunu: his son
davud: davud
kesmek: cut
oğluna: his son
davul: drum
jonas'ı: the jonas
hepsi: all
olmalısın: you should be
tamir: repair
verici: transmitter
geçtikçe: over
dağılsın: you broke
canımdır: is my life
sürüler: shoals
soyunuzu: your descendants
etmişizdir: watch muşuzdur
olmasaydı: without
sağlayacağım: i will make
çabuk: quickly
düşünürdüm: i think
geçecek: will pass
musallat: infested
denemez: do not try
babalarınızı: your father
numan'ın: the numa
sürmeli: smutty
yerden: from the ground
liderliğini: leadership
kuşku: doubt
buldular: they found
yüzünüzden: your face
beklediğini: he expects
konuşursun: you talk
çıkacaktır: will be
sence: what do you think
yatıvereceğiz: we yatıver
gidebilirsin: you can go
isli: sooty
zeki: clever
içte: inwardly
bilgilendirecektir: will inform
ondandır: it is
kalmayın: to stay
damarda: the vessel
soktuk: we put
çalışırlar: they work
gelme: do not come
kullarsınız: you can use
ejderhadan: the dragon
kaybederdik: we lose
nesi: what
gölgesinde: in the shade
devlet: state
kurtulmak: escape
buradayım: buradayım
dostlarım: my hearties
alacağını: will
buradayız: we are here
kurusun: get dry
minberin: the pulpit
kalbimdeki: my heart
nelere: how to
ruhun: the soul
mallame: but the mall
öldürürler: they killed
tahribat: destruction
söylediğin: you say
düşünmediniz: you think
düşmek: fall
misafirler: guests
düşmez: do not fall
sarayında: in the palace
hoşça: nicely
afsin: afsin
kıtlıkta: famine
sınırlarında: at the border
denenecek: to be tested
çıkacağız: we're going
Çobanlara: the shepherds
kılıcımı: my sword
tanımış: recognize that
çıkacağım: i will go out
suyla: with water
oğuz’un: oðuz
vardığımızda: there we
elenora'nın: the elenora
kurmadık: we set up
yeter: enough
düşmüşler: fallen on
akçakoca'nın: the akçakoca
avlanmaya: hunting
bugünlere: today
açık: open
meşgul: busy
gönderdiğini: send it
etmem: i would not
evleneceğiz: we're getting married
obaları: the tribe
açım: i'm hungry
dalıp: distracted
topraklar: land
öte: beyond
mahkum: convict
ceylanın: the gazelle
sağladı: provided
dediklerimiz: what we also
atmaktan: throwing
kanımız: our blood
kervanı: caravan
yetmezmiş: not enough
bilgilendirin: inform
güneş: sun
hanim: lady
batımına: sunset to
obanın: tibe's
insafı: mercy
gündemine: agenda
kabilemizi: our tribe
yaşayacak: to live
dönecek: will return
dönmezse: does not return
sevgiler: of love
güvercinin: the pigeons
sayısını: number
sözlerini: remarks
resurrection: the resurrection
onurumu: my honor
sözlerine: promises to
istediğinde: when you want
on: front
ol: be
ok: arrow
oh: oh
durdurmaya: stop
kusura: defect
yavrum: baby
karar: decision
demezsiniz: you demezs
oy: oy
bunlar: these
gaflet: heedlessness
yalvarırım: i beg
ettiğimiz: that we
sürme: drive
defa: times
diyeceklerim: more to say
deneyeceğiz: we will try
vermeye: give
ağabeyimin: my brother
kuyulara: wells
verelim: let's
yakalıyorsun: you catch
kabileyi: tribe
Şuncacık: şuncacık
haksız: unfair
gözüme: my eye
alınır: learn
shahzades: shahzades
kabileye: tribe
Önüne: before
eşiğime: my threshold
kılıcıma: my sword
yaparsanız: if you do
rachelle: rachelle
gözledi: she observed
şeyim: my stuff
ilaç: medicine
elimizde: our hands
hediyelerimi: my gift
aslanlara: to the lions
rızasıyla: with the consent
kürdoğlu'nun: the kurdoğlu
çağırıyorsun: urge you
bitirdi: finished
Şehir: city
yapılır: makes
amca: uncle
görevini: task
barışta: in peace
obadaki: in tribe
rengini: color
tapınakçı: the templar
yaşattın: you've
yemeni: yemeni
katili: killer
gözünde: in the eyes
selçuklunun: the seljuk
döndüren: returns
yaylanın: the plateau
alaycı: cynical
konudan: housing
ruhlar: spirits
seigniory'lerine: seigniory to
öğrenebildin: you learn
herkesin: everybody's
anneliğe: motherhood
gözümü: my eyes
baştan: all over
oğullarına: his sons
kahramanlığın: the heroism
babasına: his father
hayvanları: animals
geylani'nin: the geylani'nin
mahkumlarınıza: your prisoners
küspeler: pulps
sıksan: the tighter
boşaltmasını: emptying the
boğulmalı: be drowned
müslümanlar: muslims
minnettar: grateful
yaptığın: you do
kervana: caravan
duymuşsun: you heard
edemediğini: he could not
devlete: the state
hayvanlarımızı: our animals
satalım: let's sell
ayakları: legs
buyurmayın: the ordination
görüşemezlerse: if they can not see
zannetmem: i think
hiddetin: the fury
iletişimleri: communications
çıkıyorsun: you're going
kalkabileceğinizi: up to
başıboş: vagabond
ordularımızı: our army
çadırı: tents
başarısızlığa: failure
düşünmenin: thinking
demiştim: i said
sorunu: problem
tutuşacaklar: things grip
abim: brother
kabarır: swells
hiçbiri: none
alp: alp
ırmaklar: rivers
olabilirsiniz: you may
obanıza: tribe to
şartsa: unavoidable
istediğinden: want it
piyasadaki: the market
olmanız: do not
kaçak: runaway
silemezsin: you can not delete
getirecektir: will bring
kanım: my blood
kanın: blood
demiş: said
zindandan: the dungeon
bağışlamanı: the forgiveness
görüşeceğiz: we will meet
sona: ends
nasır’dan: callus
subaşı: riverhead
imanla: by faith
hamleyle: move,
birincisi: first
kürtoğlu: kurtoğlu
sonu: end
hamama: hamam
açtı: opened
çıkarır: subtracts
iradesi: will of
çıkarız: we come
hoşgeldiniz: welcome
döndürün: rotate
kilimleri: rugs
okçuları: archers
tek: single
olaydım: i events
ten: skin
kükredebilir: you can kükred
seçti: choosed
açtın: you hungry
tez: fast
adına: in the name of
yeriniz: your place
ter: sweat
miyiz: can
hasara: damage
şüpheleri: doubts
günü: day
hiçbir: no
fışkırıyor: squirt
sus: ornamental
Ölürken: dying
çıkardın: you did
sembolleri: symbols
karatoygar'ın: the karatoygar
edene: that
öldürüldü: he was killed
gözlerimdeki: in my eyes
büyülü: magical
sevdiğinle: with what you love
saklandığım: i kept
içindeki: in
konuştum: i talked to
konuştuk: we talked
gördünüz: you saw
tıkılacağımız: we stuck
dilediğinde: when expressed
öldürmeme: kill me
kızıl: red
kızım: my daughter
kızın: your daughter
bilmiyorsun: you do not know
mecalsiz: mecalsiz
kandiller: candles
alpin: alpin
rüzgara: wind
demir: iron
işlerimizi: our business
bırakmayacağım: i will not leave
toprağında: the earth
giderim: i will go
anlamıyorum: i do not understand
özgürce: freely
kışlamak: overwinter
boyumuz: our height
düşüreceğiz: will reduce
cesetlerini: the bodies
huzur: serenity
boyumun: my height
kafanı: head
varmış: had
gideriz: we go
söylemiştin: tell you
tuttu: kept
uyandırdı: aroused
vermeden: without
düşünüyorum: i'm thinking
sormam: to ask
dirimi: alive my
biliyorsunuz: you know
sormak: ask
boyu'ndansınız: you boyu'ndans
dökmekle: to pour
aşağı: down
dolayı: because
diyeceğiz: we say
bakacağım: i look
geldiğim: i came
muzafferüddin: you muzafferuddin
kışkırttığını: kışkırttığını
eden: community
nerede: where
yetişmek: catch up
ense: nape
şubesinden: branches from
müslümanların: muslims
şüphelenemeyeceği: not suspected
dışında: outside
eder: it
sonunda: finally
kahramanlık: heroism
yemeği: food
avrupa'nın: europe
eksiği: missing
yerleştirdi: placed
çağırmıştı: urged
sorularınızı: your questions
geçiyorlar: they run
konuşmaya: to talk
kanında: in the blood
biricik: only
İnsafın: of mercy
açılma: opening
vermezsek: we do not
edilecekse: if the
kullanacağım: i will use
manevi: spiritual
elleriniz: your hands
bakacaklar: they will look
oturan: sitting
sessizlik: silence
konuşsana: talk to me
ordusuyla: the army
süleyman’a: solomon
gönderse: if sending
sıkıcı: boring
yedi: seven
İsteğinizi: your request
yaptıklarında: do they
ağırlık: weight
borçluyuz: we owe
sırlar: secrets
Üstüme: above me
bozuntusunun: the hack
çalışıp: working
aslanı: lion
alpleriyle: the alps
teke: goat
yerleştirilebilir: can be placed
kulağında: ear
göçebe: wandering
kışlak: overwintering
şerefimdir: it is my honor
merhemiydi: it was ointment
kalbinin: heart
susar: susar
babasının: the father
yüzsüz: shameless
rüyamdasın: you're my dream
allah'a: allah
harap: ruined
vermedi: i did not
tehlike: danger
dokudum: i tissues
sevdiklerimizin: loved ones
basıldığında: pressing
değerlerini: their value
çakal: jackal
hatamda: my fault
sofranızı: your table
latinler: latinos
edenleri: those who
güzelliğini: your beauty
muhammed'in: the muhammad
emri: warrant
ödüllendirirdi: he rewarded
sabırsızlanıyorduk: we can not wait
etmeyeyim: i do not
kurulacak: will be installed
sabır: patience
uyanırsa: if he wakes up
yaralıyı: wounded
seferi: expedition
halep'ten: from halep
yakıyor: burning
kabiliniz: k department
mutlaka: surely
merhametli: merciful
parçalara: parts
peşimizi: us alone
topraklarına: their land
doğrudan: directly
dönemeyeceğim: i will not return
yapmıyor: does not
solmuş: faded
hileleri: cheats
zamanlarda: in time
hayvancağıza: animals over the
ikna: persuasion
alınca: taken by the
kılıcımız: our sword
kocadı: her husband
kurtarabilirsin: you can save
öncü: precursor
efendimun: the efendimu
gözleriniz: your eyes
Öylesine: such
nefesimizi: our breath
kardeşiz: brothers
kabileniz: your tribe
bulsan: if you find
etmedin: you did not
etmedim: i did not
kabilenin: the tribe
kalacaktır: will remain
kardeşim: my brother
bulasın: find press
üstüne: over
göremezsem: i do not see
hile: trick
başlayınca: starts
çalışma: work
uzaktayken: while away
beylerin: the gentlemen
keykubad’ın: the keykubad
geçmeli: interlaced
geliyorum: i am coming
töreni: ceremony
sessiz: quiet
gelmedin: you did not come
görüşürüz: see you
ölmedi: it did not die
kimden: from who
geliyoruz: we are coming
kuzgun: raven
kopartırım: i pluck
rahatsızlık: discomfort
yıkanacaksın: be washed
alırsın: you get
dönene: returning to
kuzusu: lamb
ablanın: sister
üzülüyorsan: sorry you
aracı: mediator
kurtaracak: will save
pisliklerden: of dirt
olacağına: would be
duyarsın: you heard
yerlerde: places
bırakmıştır: it has left
yükseleceğiz: will rise
esas: basis
ayrılmamalıydın: you should leave
hangi: which
Öyle: so
bravo: bravo
evine: house
getirmişler: they brought
günlerinde: in the days
Çocuğu: children
yaptın: you did
yaptım: i did
gevşektin: you loose
yaptık: we did
allah'ı: allahı
laflarını: their words
süreceklerdi: they would
müminin: the believers
İkisini: both the
akçakoca’ya: akçakoca to
namus: honor
rahmeti: mercy
gönlümü: my heart
içini: for
içine: into
dans: dance
evimize: our house
yüceltmektir: to glorify
öldürenler: who kill
kumandanını: commander of the
bilelim: let us know
gelemem: i can not come
onlarcasının: of dozens
mallarımı: my goods
dinç: vigorous
davranıyor: treats
meselesi: matter of
vazifeni: the task
geçerdi: it would pass
dedim: i said
dedin: you said
tekine: only the
gideceğin: you go
olursunuz: you are
gideceğim: i will go
sinirlisiniz: you're upset
incinmemiş: unhurt
safalar: are pure
sizden: from you
gibiydi: it seemed to
hikayesi: story
birbirimize: each other
ayakçısı: errand boy
güçlülerse: they are strong
gideceğiz: we will go
yaratıyorduk: we are creating
hazırlanmış: prepared
çıktığında: when out
hatırlattı: recalled
konuşacaklarım: what you speak
pişirir: cook
âleminin: of the worlds
bulaştırdığı: infect the
çağırırsın: you call
shahzades'i: the shahzades
kardinal: cardinal
titus'u: titus is
aman: oh
hallederiz: hallederiz
geciktirdik: we delay
edersen: will you
bilemez: do not even
rehber: guide
yardımcımız: our help
tacı: crown
olma: being
Öfkeye: anger
hedeflerini: the target
bulunduğum: i found
giren: incoming
annesi: mother
diliniz: your language
ihanetinden: the betrayal
ertuğrul: ertuğrul
toprak: soil
tanrı'nın: the gods
kaçabiliriz: how can
kederin: the grief
saldırıya: attack
kalan: remaining
parça: piece
girdik: we entered
bölgesini: of the
aşılmaz: insurmountable
hatta: even
götürebilirim: i can take
eğilimim: i tend to
mecalsizdir: uzdur mecals
gezginleriz: 're travelers
gücünü: power
yalanlardan: of lies
içeri: inside
siper: trench
bildiğimiz: we know
götürebiliriz: we can take
silkeleyin: shake
kurtardın: you saved
kimin: whose
başarırsa: if success
birçok: many
eğdi: bowed
uğradınız: you suffered
yansıtsan: reflects the
hayme: hay up
bilsin: you know
uyarıydı: he was warned
arz: supply
tugrul’un: the tugrul
olmalı: should be
ara: search
gördüm: i saw
kızıyla: his daughter
dermiş: dermis
kulağına: ear
geceleri: at night
kötülükleri: evils
günahlarını: their sins
vekaleti: mandate
türleriyle: kind of
kaplarsa: if the cover
adını: name
düzeninizi: layout
dostu: friendly
nallarından: the horseshoe
olsalar: although
karargahta: at headquarters
herbalistler: herbalists
ağırlanmak: to accommodate
sokarız: we put
halime'ın: the halime
hiç: no
yemekten: eating
düşünmesini: think
bilmediğimiz: we do not know
alamayacaksın: you will not get
olanlardan: ones
beklerdik: we expect
terfi: promotion
kısas: talion
ardında: behind
söylenmiyor: can not say
geçmektense: rather than pass
İçeri: inside
kadını: woman
güvenmediğini: that trust
saĞlanan: provided
yayladan: the springs
kaçınıyor: refrains
kitabın: the book
yormayın: look no
göre: by
sakal: beard
lodge'a: lodge
kendilerini: themselves
topla: gather
akarken: flows
alaeddin: alaeddin
acele: rush
gelenlerin: from the
manzikert'te: in manzikert
ikincisi: latter
yazmadı: he did not leave
duy: heard
vazgeçemez: not give up
sözlerimde: my words
dur: stop
olursun: you'd
değişim: change
etrafımızdaki: around us
zulüm: persecution
kalbinden: from the heart
halde: although
hamile: pregnant
nefsini: the soul
konstantinapol'den: from constantinople
yazmış: he wrote
desteklememi: my support
öldürmekle: killing
kurtarmanın: recovery
bırakın: release
bulmalıyım: i have to find
duasını: prayer
itaatsizlik: disobedience
aşkıyla: with love
açığımı: my stories
bırakıp: leave
bulmalıyız: we need to find
melik: melika
indiler: landed
göçüp: passed away
yılanlar: snakes
şair: poetrist
derhal: immediately
uzun: long
elanora'yı: the elanora
kurtulamayabilir: may not get
kadına: woman
vizyon: vision
kaşlarını: frown
çocuklarla: with children
etmemiştim: i did not
atıldığını: discarded
öldürülüyorlar: they killed
çılgın: crazy
edeceğime: that i will
yerini: place
edeceğimi: i will
kalkan: shield
konuşmadı: he was speaking
arkamızda: behind us
çocuğunu: child
seçimin: election
yakışmayan: unbecoming
deliği: its hole
esirlerden: of the captives
kutsasın: bless
suyun: of water
eşek: donkey
söyleyebilir: can you tell
acısı: pain
İşkenceyle: maids
tugrul: tugrul
sorguladım: i questioned
yaklaşmak: approach
yenilmeye: to defeat
sungur: sungur
beceremediler: they failed
halkı: people
dertlenirler: they dertlenmek
ağacından: from the tree
hedefimize: our goal
hâllenirsin: you hallen
bahane: excuse
yattı: slept
etmektir: it is to
tohumlarını: the seeds
balkondan: from balcony
çileler: hanks
göbeğim: my belly
misafire: visitors to
orası: there
davranışlarınızı: your behavior
denilen: called
yemeğini: eat
öfkesinden: the anger
meşe: oak
haykırma: shouting
ediyor: ediyor
konuşayım: let me talk
söylediği: say that
yaşadığını: he lived
kazanabilirsiniz: can win
utanmalı: should be ashamed
çatlayacak: to crack
dışarda: externally
ablam: my sister
patikaya: footpath
döktün: you pour
sakladım: i hid
hizmetçisi: maid
İnan: believe
üzüntü: sadness
uyuyamadı: could not sleep
oğullarımız: our sons
hayırdır: what's up
çadırımıza: our tent
sormalısın: you should ask
dilimin: slices
yerlerine: place to
karşılaşacağı: will face
dombra: dombra
ardına: after
söyledikten: having said that,
anne: mother
gelir: revenue
öldürmekten: the murder
gelip: to come
alpleri: alps
yapamam: i can not do
peygamberin: the prophet
geliyorsun: you're coming
sökülmesi: dismantling
kanayan: bloody
ana'dan: the main
durursun: durursun
gelin: bride
keresinde: at times
acımasızlardır: are cruel
tatmin: satisfaction
sinirleniyorsun: you mad
kızlar: girls
Üst: upper
ömrüne: to life
alınan: received
pusatsız: pusatsız
öldürecekler: they will kill
pır: pr
dönmeyi: dizziness
duyan: heard
götürmüş: he took
dokunma: do not touch
göçecek: to migration
ezmeye: crush
evlatlarımdan: my son
tuzağı: trap
izleyeceksiniz: will follow
kaltağın: bitch
almışsın: you got
koruyacağız: will protect
beklermişsiniz: expect if you were
ensemizde: our necks
hedefin: the target
alçak: low
yokken: in the absence of
varacak: there will
etmiyor: does not
belaya: trouble
toparladı: he recovered
dağın: mountain
gümrükten: customs
bıdı: blah
bulabilirsin: you can find
köle: slave
ki: that
vermeyip: did not comply
dili: language
bekliyorum: i'm waiting
öğrencidir: it is a student
istiyorsunuz: would you
şüphelendik: we suspect
töremizin: our ceremony
gökçem: i gökçee
bulunur: has
tehlikeler: pitfalls
vermeyin: do not
ana'yi: mother
savaşı'ndan: the struggle
kişneme: whinny
kararlarının: decisions
istedim: i wanted
kalmamalıyız: we should not
kalmıştı: i had stayed
bildiğim: i know
bildiğin: you know
nice: nice
hükümet: government
bey'dir: and gentlemen
olumsuz: negative
atmasını: throwing the
olsanız: if you
zindandayım: i zindand
doğru: true
geçmesin: you pass
evlatlarınızı: your son
teâlâ'nın: the almighty
çıkartmadan: removing
düşmanla: the enemy
Öldürdüğümüz: we kill
onca: onca
kimsesi: anyone
İyileştiği: healed
kimselerde: in one
söylediklerimin: what i say
moğollar: moğollar
misafirlerimizi: our guests
kanat: wing
gâiubûn: gâiubûn
lafın: the word
dualarım: my prayer
özel: special
Şeyhimiz: our sheikh
öldürecektir: will kill
hayy'dan: from hayya
dönmeyesin: you return
göçerleri: the nomads
öğrenecek: to learn
derdin: the trouble
derdim: i would say
başkanları: heads
görüldü: viewed
çıbanı: chancre
İbn: ibn '
ederler: it's
anahtarı: switch
delinin: crazy
kramplarım: my cramps
içindeymişler: for if they were
tozu: dust
haberim: my news
haberin: the news
söyledi: told
aşiretin: the tribe
hatırınızı: remember your
ikimiz: both of us
götürüyorlar: götürüyorlar
Çivit: indigo
alanı: area
olacaksın: you will be
soyundansınız: you s seed
turgut’u: turgut of
sarayda: in the palace
alaeddin'in: the alaeddin
otağda: in the tent
acil: urgent
benimki: mine
akıtacağız: will shed
girmekte: entering
iflah: prosper
varlığımda: my presence
bey'imizi: our bey'i
nazik: kind
yapacağı: will do
taş: rock
beyaz: white
etime: my flesh
bürümüş: infestation by
başlıklar: headlines
kölesi: slave
belaların: of trouble
kadardır: is decided
görmesin: you see
göreceksiniz: you will see
yorma: look
bozok: bozok
iddia: allegation
yaptı: made
tepeledi: i hills
istermiş: he wanted
yaptıklarının: do they
kılıcındaki: the sword
açlıktan: from hunger
haberlerle: the news
kucağımızda: our arms
alışkın: used to
uğursuzla: uğursuzl to
ediyordu: he would
başlamıştı: he had begun
dikine: vertically
dönüşünden: his return
geleneksel: traditional
Şehrinizde: your city
İçindeki: table of contents
önümde: front of me
günahlarınızdan: your sins
mezarımız: our grave
boğazınızdan: your throat
taç: crown
şövalyesine: knights to
buluştu: met
başlıyor: starting
ağaç: tree
gönlünde: in the hearts
geri: back
bulacağım: i find
tanıdığım: i know
anahtar: key
gelmemi: me to come
ayrılmadan: leaving
soru: question
gitmiştir: is gone
gönderdiği: send it
rabbil: rabbil
rabbim: my god
çarpık: crooked
besledikleri: they feed
bakılması: to look
bilecek: will know
toplayıp: picking
değilsin: you are not
mücevherimize: our jewelry
titus'ta: in titus
gözyaşını: tears
kazanlara: to win
yurdunuzdan: your land
tas: rock
adamım: man
adamın: the man
emirin: the orders
alplerini: the alps
ağam: my network
tam: full
buydu: this was
viziyerimizden: our viziyeri
Şah'la: shah on
alâeddin'e: alaeddine to
sir: secret
cesedini: his body
tanımak: know
coşar: coşar
malların: goods
siz: you
kurutmak: dry
denediniz: have you tried
olmazsınız: you do not
canını: canını
geleneklerine: their traditions
tarafı: side
anlatma: narration
okunu: arrow
telaş: fuss
taşlattılar: they taşlat
kramplar: cramps
seneye: next year
Önceden: previously
uçarak: fly
inanıyorlar: they believe
dakikada: in minutes
Çadır: tent
düşünmemiştim: i think
ortada: in the middle
elif: elif
mekke: mekka
evleniyoruz: we're getting married
beyazlatmak: bleach
değişecek: will change
münasip: suitable
kocanın: husband
gecedir: is night
toplandı: gathered
obadakilere: obama those
gerisini: the rest
tuğrul: tuğrul
hakkından: about
parasız: free
eşkıyaların: bandits
içeren: including
çıkarmaya: removing the
suçluların: guilty of
haberiniz: your news
olmana: not to
hayatlarının: their lives
duydunuz: you heard
ön: front
crass: crassa
gözyaşı: tears
eşkıyalık: banditry
inatçıydı: he was stubborn
giydiklerimiz: what we wear
edip: whether
elimden: stripped
edin: learn
gerekti: i had to
sırların: secrets
harekete: motion
öldürmesi: killing
akmaz: it does not flow
endişelendiriyor: worries
dinlemen: do not listen
fazla: much
dinlemek: listen
saflaştırılmış: purified
öfke: anger
bilgilere: information
öldürüldüğünde: killed
rüyanın: the dream
duymazlar: not hear
kritik: critical
üzerime: upon me
soğuk: cold
tezahür: manifest
vermeyeceksin: you will not
sinecek: to sin
üzme: upset
isminizi: your name
yatalak: bedridden
gittiğini: go to it
şeylerle: with things
kesilmez: does not break
olacaktır: will be
almaktan: taking
onların: they
ayrılmayacaksın: you will not leave
dövülür: beaten
veriyordu: it was giving
sırpmış: serbs have
hareketlerden: the move
canımız: our c
olacaktın: you would be
evimi: my home
anlayamıyorum: i can not understand
görevimiz: our mission
vuracak: will hit
teklif: bid
aykız'a: aykız to
selçuklu’nun: the seljuks
dağılacak: will be distributed
çıksın: çıksın
verebileceklerini: can give
çalıştı: worked
konsey: council
olmanı: not the
döneceksin: will you be back
mudur: manager
tanımazmış: that recognize
emekler: crawl
kırılan: refracted
İşte: request
beyrek’le: beyrek'l to
düzgün: smooth
gelmeyen: endless
çalıştıklarını: they work
satılırken: sold
ahirette: hereafter
kaçırdığına: she missed
bulduğumuzu: we found
umurunda: cares
yakalaması: capture
havlıyor: barking
anlamalısınız: you must understand
olmayacak: will be
bulduğumuza: we found
vurulacak: to be hit
varırdı: there was
dertleri: troubles
kampta: camp
yapacağım: i will do
celladın: the executioner
kaçamayacağımızı: we will not escape
dürüstlüğünden: of honesty
göremezsin: you can not see
kıçı: ass
sızdı: leaked
namussuz: dishonorable
adınla: by name
özleyeceğim: i will miss
hazreti: master
fakı'ı: the phakic
çiçeğe: flowers
görürüm: i saw
Övündüğün: you brag
meseleleri: issues
sizde: in the first
koymamaya: placing
halime'ı: the halime
egzersiz: exercise
çalışan: working
görmüş: have seen
Üzüntü: sadness
söyleyebilirim: i can tell you
aramama: my search
varabileceğimi: there could
gundogdu'ya: gündoğdu
düşeriz: we fall
kıza: girl
kimdir: who
alkış: applause
veya: or
oğlu'na: his son
kuru: dry
yerde: in place
haberdar: informed
numan'ı: numai
girmeyeceğini: would enter
unutalı: forget the
vermek: give
tutuyordur: are holding
denk: equivalent
gelenin: incoming
oğlu'nu: his son
vermez: does not
işkenceler: torture
kılına: make the
kadının: woman
sakalının: beard
intikam: revenge
esma: esma
kırbaçlanıyorlar: they kırbaçlanıy
tarif: specification
hurma: date
gitmekten: to go
ertuğrul'la: ertuğrul'l to
şehzademin: my prince
nehri'nin: the river
gitmeliyiz: we should go
tahsis: allocation
koşarken: while running
sınırlarımda: my borders
siparişiniz: your order
alnının: the forehead
aramızdaki: between us
aydın: intellectual
istiyor: wants
korkma: do not be afraid
kurmak: establish
silah: gun
kurmam: i set up
sıkma: squeezing
avlanırlar: they hunt
döndünüz: you return
titus: titus
ateşlenmemişse: if fired
düştük: we fell
tutuklayan: who arrested
istemişler: they wanted
İbnü'larabî: ibnü'larabî
düşünüyorsun: you are thinking
şehri: city
tuttum: i kept
ebe: midwife
güçlüyseniz: if you force
çoban: shepherd
bekler: waits
sözümü: my promise
giyiyor: wearing
açmanı: open the
ebu: ebi
yaralarını: their wounds
yakalayalım: let's get
durmayacağı: will stop
sokaktan: the street
konulduğu: it is placed
rüyayı: dream
girebiliriz: we can enter
komutanlarımla: among commander
yükleyip: install
yükleyin: install
oralarda: there
bükülmedi: was bending
geldiğimde: when i came
çekiyorlardı: they were pulling
yaman: egregious
destekleyeceğimi: i support
amen: amen
köprüden: the bridge
avı: hunt
konusunu: subject
mısır'a: corn
hayallerim: my dreams
hu'ya: hue
istediğim: i want
istediğin: you want
İtme: push
Örelim: i weave
girip: enter
evleniyorlar: getting married
İbnü'larabî'den: from ibnü'larabî'
yaklaşsa: came close to
çıktım: i went
öldürülmeden: being killed
baktığın: you look
sandığımızdan: we thought
aklıdır: mind is
haddimi: my place
açma: opening
sultan’a: sultana
gidin: go
edeyim: i will
pusatlarımı: my pusat
intikamının: of vengeance
cesaret: courage
tutmamızdan: keep our
uymalıyız: must comply
pusaklanmış: pusakl were followed
delinsin: you are punctured
atla: skip
İşine: business to
alamazsın: you can not
ezip: crushed
Şöhretin: fame
ağırlayın: entertain
unutulur: forgotten
güvenmeniz: trusting
diğer: other
yükü: load
söyleyebileceği: can tell
düştüğünde: falls
beyimiz: our brain
kuralları: rules
bitene: finished until
hancı: innkeeper
duyar: hears
dönsünler: they returned
ister: either
gümrüklerimizde: our customs
beyimin: my brain
olmasınlar: let them be
Çevre: environment
kırar: breaks
deden: grandfather
toygar: meeting
artıracak: will increase
ulaşmamıza: us reach
yapmaya: making
wild: the wild
temsilen: representative
karavan: caravan
duanı: prayer
kolladınız: you watch
haline: into
çattığını: that conflicts
hastalanabileceği: be ill
bahsedeceğim: i will tell
gündür: day
gündüz: day
gömerim: i buried
ava: hunting
niyetleri: intentions
anlaşmazlığa: dispute
beklerler: they expect
liderin: leader
adaletinizin: your justice
selçuklular: seljuks
yansımasıdır: it is a reflection
ince: thin
ediver: acidifying the
söylemek: say
kıymış: have meat
göstermesin: you show
selçuklu’yu: the seljuks
yakından: closely
süreliğine: while the
beynin: the brain
kurban: sacrifice
mekke'yle: mekke'yl to
saçından: the hair
çekiyordur: is drawing
selçuklu’ya: seljuks
etmek: to make
körken: blinded
mahsustur: belongs
saldırma: attacking
bilmeyiz: we do not know
moorland: moorland
İnşallah: god willing
ablasının: of sister
vururum: i shoot
gözlere: eyes
hale: hale
gözleri: eyes
halkını: people
arıyorsun: are you looking
götürürüm: i'll take
Çalıştırmak: run
atıyorsun: you throw
kazanacaktı: would win
burunlarımızın: our nose
kıvılcım: spark
keserdim: i'd cut
onunla: with him
yönlendir: directs
göründüğünden: it seems
bulur: finds
bulup: find
yatırırsınız: you deposit
bulut: cloud
itliğini: itlig the
ısrar: insist
kapısını: door
yaparsam: i make
gidelim: lets go
başladınız: you start
götüren: leads
yanımdan: by me
ummulhayr: ummulhay is
fitilin: suppository
ummulhayl: ummulhayl
bekir: bekir
üstesinden: overcome
karıştıracakları: will stir
utanmaz: shameless
inanıyorum: i believe
gençlerde: young people
baharı: spring
Şehzade: prince
adamlarının: man of
İbrahim'in: abraham
yetişemediniz: did not catch
candan: cordially
kabilesini: tribe
utanman: do not be ashamed
isadora: isadora
muhafız: guardian
yaşadıklarını: they live
görevlerinin: duties
densizlik: inconsiderate
attın: you put
hangisi: which
gördüklerini: they saw
görüşmedik: we interview
Şahımız: our shah
platformu: platform
hatırlamayacaksın: you will not remember
koyulma: placing
kıpırdama: hold still
adamdan: the man
yaptınız: you did
ayıya: bear
tutmamıza: us to keep
bırakmayacaksın: you will not leave
aksiyon: action
kırmadım: i break
kopararak: cleaving
emridir: warrant is
giderse: if you go
eceliniz: your death
kalırsın: you're
giydi: wore
kırdık: we broke
çınar: plane
kırdım: i broke
sallayamaz: not nod
kocasın: you husbands
kaltak: bitch
aydınlatan: illuminating
birbirlerine: to each other
dayanabilecek: can withstand
durdurmak: stop
birbirlerini: each other
başını: head
karşısında: against
koşacak: will run
izninizle: with your permission
sürekli: continuous
birlikteyiz: we are together
beraberliğin: togetherness
tanıştırmak: introduce
kuvvetli: powerful
kalmayacaktır: will remain
tacirin: the traffickers
süt: milk
öz: self
senelerdir: for years
takılıp: stuck
selameti: salvation
tamam: ok
evelallah: by Allah
güvenilir: reliable
kaçırmışsınız: you missed
mektupta: in a letter
vay: wow
kılıçlarına: the sword
var: there is
atları: horses
kuracağız: we will establish
venedikliler: venetians
candaş: candash
yaygara: fuss
kullanabileceğimiz: we can use
ustadi: the ustad
davrandığı: act as
acılardan: from suffering
yaşadığımız: we live in
kardeşimi: my brother
ferah: spacious
kardeşime: my brother
kazanına: won the
hilal: crescent
akdeniz'den: the mediterranean
Ömrümde: my life
günümüz: nowadays
düştüm: i fell
kabilenizin: your tribes
anlaşabiliriz: we can agree
cüret: daring
kast: caste
ayrılmadığı: by separation
kibirliydim: i was arrogant
başarabilir: can achieve
girmek: enter
vazgeçeceksin: you give up
itler: push on
kuyruk: queue
başına: per
azam'ı: maximum
kapıda: at the door
harcayamayız: we can not spend
girmez: does not enter
anlıyorum: i understand
yağmurlar: rains
kabuğu: shell
canına: dear to
ayyubi'yi: the ayyub
aşkım: darling
aşkın: over
bekletmeyelim: wait a little
bezelye: pea
üzerinize: upon you
mıdır: is it
hristiyanlara: to christians
yeşil: green
öngörmek: to predict
atölyesinin: workshop
ayıyı: bear
şeye: thing
boynundan: from the neck
sultanla: the sultan
şeyi: thing
endişelenmeyin: do not worry
fitne: sedition
hareketlilik: mobility
tuhaflık: strangeness
aptalca: stupid
geciktik: we're late
geciktim: i am late
ortasında: midst
cetvel: ruler
ağustos: august
kalbi: heartland
